#!/bin/bash
# This file was generated via DeepL machine translation from en
# Filename: <lng>/lang.txt - coded in utf-8
# Language variables for cgi pages in the user language
# --------------------------------------------------------------
displaynameINFO="Autorun"
descriptionINFO="A külső meghajtón (USB / eSATA) végrehajt egy szkriptet, amikor az a lemezállomáshoz csatlakozik."
LoginRequired="Bejelentkezés szükséges"
PleaseLogin="Kérjük, először jelentkezzen be adminisztrátorként, mielőtt használná ezt a weboldalt."
settingsTitle="Aktuális $app_name Beállítások:"
logTitleExec="Műveleti napló (eszközcsatlakozás, szkriptek végrehajtása és az eszköz eltávolítása)"
logTitleDetail="A tevékenységek hibakeresési naplója. A tényleges naplózási szint '$LOGLEVEL'."
settingFingerprint="A root hozzáféréssel végrehajtott szkript biztonsági kockázatot jelent, különösen, ha a külső tárolóhelyen van beállítva. A végrehajtás korlátozható a korábban regisztrált SHA256 ellenőrzőösszegnek megfelelő szkriptekre.<br>0: Nincs korlátozás. A korábban regisztrált ellenőrző összegek megmaradnak.<br>1: Ha vannak korábban regisztrált ellenőrző összegek, azok törlődnek. Az 1. szkript a saját ellenőrzőösszegével együtt engedélyezett ellenőrzőösszegként kerül regisztrálásra.<br>2: Minden szkript engedélyezett, és az ellenőrző összegek regisztrálásra kerülnek, ha még nem regisztrálták korábban.<br>3: Csak a korábban regisztrált ellenőrző összegekkel rendelkező szkriptek engedélyezettek."
settingSecurityWarning="<span style=\"color:red\"><b>Figyelem:</b></span> Az a) szkriptváltozat (külső USB/eSATA eszközön lévő szkript) és a 0 vagy 2 ujjlenyomat-beállítás kombinálása kritikus biztonsági kockázatot jelenthet: A külső tárolóeszközön lévő tetszőleges tartalmú szkriptek a csatlakoztatáskor végrehajtódnak, és mindenhez hozzáférnek! A csatlakoztatás elég lehet a Synology NAS-on lévő adatok megsemmisítéséhez vagy ellopásához!"
settingScript="A változat: A szkript a külső tárolóeszköz gyökérkönyvtárában található, és a \"root\" felhasználó számára futtathatónak van beállítva. Megadva van a szkript tiszta neve, elérési útvonal és kötőjel nélkül.<br>b) változat: A szkript a teljes elérési útvonallal van megadva, és a NAS-on található.<br>Elérkezik az eszköz csatlakozási pontjához (pl. /volumeUSB1/usbshare/) mint első paraméter (\$1) és az eszköz partíciójához (pl. usb1p1) mint második (\$2). A programnak futtathatónak kell lennie a 'root' számára. A 'root' számára a DSM 7-ben az 'ash' héjat használják. De a /bin/ash lehet a 'bash' linkje (legalábbis a DS220 -on). A szkriptet üres környezettel indítja! Tehát nincs PATH beállítva. Minden parancshoz a teljes elérési utat kell használni (pl. /bin/echo \"...\", /bin/printf ...). A szkripted megállhat 2-es kilépési kóddal, ha egy parancsot nem találsz a hiányzó elérési útvonal miatt. A szkripted első soraiban használhatsz egy 'unset PATH'-t, hogy a szkript hibakereséses futtatásakor ugyanazok a feltételek legyenek. Vagy a szkripted elejére egy olyan sort írhatsz, mint 'PATH=/sbin:/bin:/usr/sbin:/usr/bin:/usr/syno/sbin:/usr/syno/bin:/usr/local/sbin:/usr/local/bin'."
settingScriptAfter="Ha a szkript a 100-as kilépési kóddal lép ki, akkor az autorun ki fogja dobni a tárolóeszközt, és utána meghívja ezt a 2. szkriptet. Ez opcionális. Tipikus felhasználási módja egy külső tápellátással rendelkező merevlemez kikapcsolása egy intelligens tápegységen keresztül."
settingTries="Az az idő (másodpercben), amíg az autorun keressen egy csatlakoztatott meghajtót. Növelje ezt az értéket, ha a \"nem találja a csatlakoztatási pontot\" hibát kapja."
settingWait="További várakozási idő (másodpercben) a szerelés észlelése után a parancsfájl elindítása előtt. Bizonyos esetekben néhány másodperces késleltetésre van szükség a megfelelő meghajtóhoz való hozzáféréshez."
settingBeep="Ha 'true' értékre van állítva, akkor egy rövid hangjelzés hangzik el, amikor egy szkriptet talál. Hiba esetén pedig háromszoros hosszú hangjelzés."
settingLedStatus="Az állapot LED a szkript állapotának jelzésére használható.<br>0: Az állapot LED-et ez a csomag használja.<br>1: 1: Zöld futás közben, zöld villogás kilövés közben, KI, ha 0 vagy 100-as eredménnyel fejeződött be, narancssárga villogás egyéb eredmények vagy sikertelen kilövés esetén<br/>2: Zöld villogás a szkript futása vagy kilövése közben, zöld villogás, ha 0 vagy 100-as eredménnyel fejeződött be, narancssárga villogás egyéb eredmények vagy sikertelen kilövés esetén<br/>3: Zöld villogás a szkript futása és kilövés közben, KI, ha befejeződött, narancssárga villogás sikertelen kilövés esetén."
settingLedCopy="A státusz LED a szkript állapotának jelzésére is használható.<br>0: Ez a csomag a másolás LED-et használja.<br>1: Futtatás vagy kidobás közben bekapcsol, utána kikapcsol<br/>2: Futtatás vagy kidobás közben villog, utána kikapcsol<br/>3: Futtatás vagy kidobás közben bekapcsol, utána kikapcsol (0/100) vagy villog (egyéb kódok)<br/>4: Futtatás vagy kidobás közben villog, utána kikapcsol vagy villog (egyéb kódok vagy kidobás sikertelen)<br/>5: Futtatás vagy kidobás közben villog, utána kikapcsol (0/100) vagy bekapcsol (egyéb kódok vagy kidobás sikertelen)."
settingNoDsmMessageReturnCodes="Általában egy DSM asztali üzenet jelenik meg a szkript befejezése után. Az üzenet tartalmazza a szkript visszatérési kódját és a tárolóeszközön fennmaradó szabad helyet. Ha a szkript az itt megadott kódok valamelyikével lép ki, akkor nem generálódik ilyen üzenet. A csomag naplófájljában továbbra is keletkezik egy bejegyzés."
ledResetHint="A LED-beállításoktól függően az eszközön lévő LED-ek a parancsfájl befejezése után hibaállapotot jelezhetnek. A <span style=\"font-family:'Courier New'\" translate='no'>echo 8 4 B> /dev/ttyS1</span> paranccsal, amelyet '<span translate='no'>root</span>' néven hajtunk végre, visszaállítható a normál állapot. A vezérlőpultban létrehozhat egy ütemezett feladatot egy egyéni szkripthez a <span translate='no'>root</span> felhasználó számára a run parancs <span style=\"font-family:'Courier New'\" translate='no'>echo 8 4 B> /dev/ttyS1</span> (8: Status LED zöld, 4: Power LED be, B: Copy LED ki). És futtasd le, ha szükséges a LED-ek visszaállítása."
settingEjectTimeout="Ha a 100-as kilépési kód esetén a külső meghajtó nem dobható ki (mivel foglalt), akkor ez megadja az időkorlátot másodpercben, mielőtt hiba miatt befejeződnek a kilövési kísérletek."
settingLogMaxLines="Annak elkerülése érdekében, hogy túl sok helyet foglaljanak a naplófájlok, a fájlok idősebbik fele törlődik, ha a sorszám elérte a megadott számot."
settingLogVerbose="A hibakeresési naplófájlba történő üzenetíráshoz több részletességi szint áll rendelkezésre: 1 ... 8. Minél magasabb az érték, annál több a részletesség."
settingNotifyUsers="A csomag asztali értesítéseket generál, amelyek egy konfigurálható felhasználó vagy felhasználói csoport számára jelennek meg. A '@' betűvel kezdődő név egy csoport neve."
settingHeadlineFingerprints="Jelenleg regisztrált SHA256 ellenőrző összegek (ujjlenyomatok) a szkriptfájlokról:"
runInstallationAgain="A beállítások módosításához vagy az ellenőrző összegek törléséhez újra lefuttathatja a telepítést!"
ledCtrlHint="Ha a LED-ek jelzése még mindig hibát jelez, itt visszaállíthatja:"
btnCopyLedOff="Másolás LED OFF"
btnStatusLedGreen="Állapot LED zöld"
btnStatusLedOff="Állapot LED OFF"
btnDelLog="Törölje ezt a naplófájlt"
btnRefresh="Oldal frissítése"
btnShowDetailLog="Részletes hibakeresési naplófájl megjelenítése"
btnShowSimpleLog="Egyszerű napló megjelenítése"
hrefLog="Az intézkedések naplója"
btnShowLicence="Engedély"
btnShowSettings="Beállítások megjelenítése"
btnDownload="Letöltés ..."
execLogNA="A naplófájl nem található vagy üres. A csomag elindítása után már volt egy tárolóeszköz a gyökérmappában csatolt szkriptfájllal a csomag indítása után?"
HASH_DELETION="<b>A korábbi regisztrált hash-ok mostantól mind törölve vannak.</b>"
copyPriviledge="A szükséges parancsot <input type='text' size='80' value='sudo cp /var/packages/$SYNOPKG_PKGNAME/conf/privilege.root /var/packages/$SYNOPKG_PKGNAME/conf/privilege'> SSH-n keresztül (vagy ütemezett feladattal)<strong>most!</strong> Az 'OK' után a csomagot a 'Run' paranccsal indíthatja el."
scriptNA="Hiba: Skript '$f' nem található!"
scriptNAcase="Gyanús: Különböző nagy- és kisbetűs fájlokat találtunk!"
setupCorrection="Esetleg újra kell futtatni a telepítést a beállítás javításához!"
scriptNexec="Hiba: Skript '$f' nem futtatható!"
wrongLineBreakWin="Hiba: Skript '$f', amelyet végre kellene hajtani, rossz sortörést használ CR/LF (Windows). Kérjük, használjon egy megbízható szerkesztőt (Linux vagy Windows Notepad  , PSPad, ...), hogy LF-re módosítsa (UNIX)!"
wrongCodePage="Hiba: Skript '$f', amelyet végre kellene hajtani, rossz kódolást használ (Windows ISO-8859). Kérjük, használjon egy használható szerkesztőt (Linux vagy Windows Notepad  , PSPad, ...), hogy UTF-8-ra módosítsa!"
wrongLineBreakMac="Hiba: Skript '$f', amelyet végre kellene hajtani, rossz sortörés CR-t használ (MAC). Kérjük, hogy a siutable Editor segítségével változtassa meg LF-re (UNIX)!"
notifyUserError="A '$notyfyUsers' felhasználói fiók az asztali üzenetekhez nem létezik! Ezért a rossz bejegyzést a '@users' csoportra cserélte. Futtassa újra a telepítést, hogy más értéket adjon meg!"
notifyGroupError="A '$notyfyUsers' felhasználói csoport az asztali üzenetekhez nem létezik! Ezért a rossz bejegyzést a '@users' helyettesíti. Futtassa újra a telepítést, hogy más értéket adjon meg!"
update_available="<span style='color:red'>A ${app_name} frissítés elérhető a GitHubon.</span> Kérjük, frissítse a ${local_version} verzióját a következő verzióra"
txtAlertOnlyAdmin="A hozzáférés csak a rendszergazdák csoport tagjai számára engedélyezett."
txtLanguageSource="Az oldal nyelve az Ön böngészőjének regionális beállításai szerint lett kiválasztva."
preinstDsmVersError="Ez a csomagváltozat csak a DSM ${osMin} és magasabb verzióban használható! Korábbi csomagverziók is lehetségesek az Ön DSM verziójánál, lásd <a target='_blank' rel='noopener noreferrer' href='https://github.com/reidemei/synology-autorun#install'>https://github.com/reidemei/synology-autorun#install</a>"

