#!/bin/bash
# This file was generated via DeepL machine translation from en
# Filename: <lng>/lang.txt - coded in utf-8
# Language variables for cgi pages in the user language
# --------------------------------------------------------------
displaynameINFO="オートラン"
descriptionINFO="外付けドライブ（USB / eSATA）をDisk Stationに接続した後、そのドライブに対してスクリプトを実行することができます。"
LoginRequired="ログインが必要です"
PleaseLogin="このページを使用する前に、まず管理者としてログインしてください。"
settingsTitle="実際の$app_nameの設定。"
logTitleExec="アクションのログ（デバイス装着、スクリプト実行、デバイス排出）"
logTitleDetail="アクティビティのデバッグログ。実際のログレベルは'$LOGLEVEL'です。"
settingFingerprint="ルート権限で実行されるスクリプトは、特に外部ストレージに保存されるように設定されている場合、セキュリティ上のリスクがあります。事前に登録したSHA256チェックサムに一致するスクリプトに実行を制限することができます。<br>0：制限なし。<br>1：過去に登録されたチェックサムがある場合、それを削除します。<br>2: すべてのスクリプトが許可され、チェックサムが登録されていない場合、登録されます。<br>3: 以前にチェックサムが登録されたスクリプトのみが許可されます。"
settingSecurityWarning="<span style=\"color:red\"><b>Attention:</b></span> スクリプトのバリエーション a) (外部 USB/eSATA デバイス上のスクリプト) と指紋設定 0 または 2 を組み合わせると、重大なセキュリティ リスクとなる可能性があります。外部ストレージ デバイス上の任意のコンテンツを持つスクリプトは、接続されたときに実行され、すべてにアクセスできるようになります。それを接続すると、Synology NAS のデータを破壊したり、盗んだりすることができます!"
settingScript="変形例a．スクリプトは、外部ストレージ デバイスのルート ディレクトリにあり、ユーザー「ルート」の実行可能ファイルとして設定されます。<br> 変形例 b: スクリプトはフルパスで与えられ、NAS に配置されます。<br>最初のパラメーター (\$1) としてデバイスのマウント ポイント (例 /volumeUSB1/usbshare/) を取得し、2 番目 (\$2) としてデバイス パーティション (例 : usb1p1) を取得します。rootで実行可能である必要があります。DSM 7 では 'root' のために 'ash' というシェルが使われます。しかし、/bin/ash は 'bash' へのリンクであるかもしれません (少なくとも DS220  では)。スクリプトは空の環境で起動されます!そのため、PATH は設定されていません。各コマンドでフルパスを使用する必要があります (例: /bin/echo \"...\", /bin/printf ...)。パスが不明なためにコマンドが見つからない場合、スクリプトは終了コード 2 で停止することがあります。スクリプトの最初の行で、'unset PATH' を使用すると、スクリプトのデバッグ実行時に同じ状態にすることができます。あるいは、スクリプトの最初の行に 'PATH=/sbin:/bin:/usr/sbin:/usr/bin:/usr/syno/sbin:/usr/syno/bin:/usr/local/sbin:/usr/local/bin' などの行を追加してください。"
settingScriptAfter="スクリプトが定義された終了コードで終了した場合、autorunはそのストレージデバイスをイジェクトし、その後、この2番目のスクリプトを呼び出します。これはオプションです。典型的な使用方法は、スマートパワーアダプターによる外部供給でHDDをパワーダウンさせることです。"
settingTries="autorunがマウントされたドライブを検索する時間（秒）です。unable to find mount point \"エラーが発生した場合は、この値を増やします。"
settingWait="スクリプトを開始する前に、マウント後の追加の待ち時間（単位：秒）が検出されます。場合によっては、適切なドライブアクセスのために数秒の遅延が必要です。"
settingBeep="true'に設定すると、スクリプトが見つかったときに短いビープ音が鳴ります。また、エラーの場合は3倍の長さのビープ音が鳴る。"
settingLedStatus="ステータスLEDは、スクリプトの状態を表示するために使用できます。<br>0：本パッケージではステータスLEDは使用されません。<br>1：実行中緑、イジェクト中緑点滅、0またはイジェクト用に定義されたコードの1つで終了した場合はOFF、その他の結果またはイジェクトに失敗した場合はオレンジ点滅<br/>2：スクリプト実行中またはイジェクト中緑点滅、0またはイジェクト用に定義されたコードの1つで終了した場合は緑、その他の結果またはイジェクトに失敗した場合はオレンジ点滅<br/>3：実行中およびイジェクト中緑、終了時OFF、イジェクト失敗時はオレンジ点滅。"
settingLedCopy="また、ステータスLEDはスクリプトの状態を表示するために使用できます。<br>0：本パッケージではコピーLEDは使用されません。<br>1：実行中またはイジェクト中はON、その後はOFF<br/>2：実行中またはイジェクト中は点滅、その後はOFF<br/>3：実行中またはイジェクト中はON、その後はOFF（0またはイジェクト中のコードのいずれか）または点滅（他のコード）<br/>4．走行中または排出中に点滅、その後OFFまたは点滅（他のコードまたは排出失敗）<br/>5：走行中または排出中に点滅、その後OFF（0または排出を伴うコードの1つ）またはON（他のコードまたは排出失敗）<br/>6：走行中または排出中に点滅、その後OFFまたは点滅（0または排出を伴うコードの1つ）<br/>7：走行中または排出中に点滅。"
settingNoDsmMessageReturnCodes="通常、スクリプトが終了すると、DSMデスクトップメッセージが生成されます。このメッセージにはスクリプトのリターンコードと、ストレージデバイスの残りの空き容量が含まれている。スクリプトがここで指定されたコードで終了した場合、そのようなメッセージは生成されません。パッケージのログファイルにはエントリが生成されます。"
settingEjectTimeout="デバイスの取り出しに設定された終了コードの場合、外付けドライブがビジー状態で取り出せない場合、エラーで取り出しを終了するまでのタイムアウトを秒単位で指定します。"
settingLogMaxLines="ログファイルの容量が大きくなりすぎないように、行数が指定した数に達した場合、ファイルの上半分を削除するようにしました。"
settingLogVerbose="デバッグログファイルへのメッセージの書き込みには、いくつかの詳細レベルが用意されています。1 ... 8.値が高いほど、より詳細な情報が得られます。"
settingNotifyUsers="このパッケージはデスクトップ通知を生成し、設定可能なユーザーまたはユーザーグループに表示されます。<br>ヒント：<br> 管理者もグループ <code>@users</code> のメンバーです。<br>コマンド <code>/usr/syno/bin/synodsmnotify -c ◆\"SYNO.SDS._ThirdParty.App.autorun\" ◆\"@users\"\\"autorun:app1:title02\\"\\"autorun:app1:msg0 \"と表示されます。\\"＜あなたのメッセージのテキスト＞\"</code>を使えば、スクリプトの中から追加のメッセージを生成することができます。"
settingHeadlineFingerprints="現在登録されているスクリプトファイルのSHA256チェックサム（フィンガープリント）です。"
settingCapture="<br>0：出力はキャプチャされません。<br>1：出力はAutorunのメインアクションログに挿入されます。<br>2：出力はデバッグログに挿入されます。"
settingsEjectReturnCodes="スクリプトは、リターンコード 0 ... で終了することができます。255.スクリプト終了後に外部記憶装置を排出するリターンコードやリターンコードの範囲を指定することができます。"
settingFailureCodes="スクリプトの終了コード一覧。失敗とみなされ、LEDやビーパーで通知される可能性があります。"
settingCGIDEBUG="&lt;empty&gt; です：index.cgiとsettings.cgiを実行してもデバッグログが生成されない：index.cgiとsettings.cgiを実行すると、デバッグログエントリが生成されます。他の問題のデバッグ時に混乱する可能性があります。"
runInstallationAgain="設定を変更したり、チェックサムを削除するために、もう一度インストールを実行することができます"
ledCtrlHint="LEDの表示がエラーのままであれば、ここでリセットすることができます。"
btnLedOff="オフ"
btnLedOn="オン"
btnStatusLedGreen="グリーン"
labelStatusLed="ステータスLED"
labelCopyLed="コピーLED"
btnLedFlash="てんめつ"
btnLedGreenFlash="緑色の点滅"
btnLedOrangeFlash="オレンジ色の点滅"
btnLedOrange="オレンジ"
btnDelLog="このログファイルを削除する"
btnRefresh="ページ更新"
btnShowDetailLog="詳細なデバッグログファイルの表示"
btnShowSimpleLog="アクションログファイルの表示"
hrefLog="アクションのログ"
btnShowLicence="ライセンス"
btnShowSettings="表示設定"
btnDownload="ダウンロード ..."
execLogNA="ログファイルが見つからないか、空です。起動後、記録すべきイベントはありましたか？"
HASH_DELETION="<b>過去に登録したハッシュはすべて削除されました。"
copyPrivilege="<strong>重要:</strong> DSM 7.x ではサードパーティーのパッケージが Synology によって制限されているため、インストールを確定してパッケージを実行できるようにするには、さらなるステップが必要です。<br>次のコマンドを実行する必要があります：<input type='text' size='80' value='sudo cp /var/packages/\$SYNOPKG_PKGNAME/conf/privilege.root /var/packages/\$SYNOPKG_PKGNAME/conf/privilege'> <strong>Posibillity 1：</strong><br> NASへのSSHコマンドシェル（adminユーザーとして）開いて上記コマンドを実行します。<br><strong>Posibility 2:</strong><br>ヒント: もしあなたが以前に既にこれを行ったなら、ステップ2.2.<br>2.1へジャンプすることができます：<br>2.1: コントロールパネルから「タスクスケジューラー」に移動し、ユーザー定義スクリプトでスケジュールタスクを作成します。一般タブでは、便利な名前を設定し、ユーザーとして'root'を選択します。スケジュール」では、過去の日付と「繰り返さない」を選択できます。タスクの設定」で、上記のコマンドを「ユーザー定義スクリプト」としてコピー＆ペーストします。タスクの設定を終了し、警告を確認します。<br>2.2：生成されたタスクを選択し、<strong>実行</strong>します。<br>2.3：コントロールパネルを閉じ、このダイアログもここで閉じます。パッケージセンターの「インストールされたパッケージ」からAutorunパッケージを選択し、<strong>実行</strong>します！"
scriptNA="エラーが発生しました。スクリプト '$f' が見つかりませんでした。"
scriptNAcase="疑わしい：大文字と小文字が異なるファイルが見つかりました。"
setupCorrection="もしかしたら、もう一度インストールを実行して、設定を修正する必要があるかもしれませんね。"
scriptNexec="エラーが発生しました。スクリプト '$f' は実行可能ではありません!"
wrongLineBreakWin="エラーです。実行されるべきスクリプト '$f' は、間違った改行 CR/LF (Windows) を使用しています。LF (UNIX)に変更するには、siutable Editor (Linux order Windows Notepad  , PSPad, ...) を使用してください!"
wrongCodePage="エラーが発生しました。実行されるべきスクリプト '$f' は、間違ったコーディング (Windows ISO-8859) を使用しています。siutable Editor (Linux oder Windows Notepad  , PSPad, ...) を使って、UTF-8に変更してください!"
wrongLineBreakMac="エラーです。実行されるべきスクリプト '$f' は間違った改行 CR (MAC) を使用しています。siutable Editorを使ってLF (UNIX)に変更してください!"
notifyUserError="デスクトップメッセージのユーザーアカウント '$notyfyUsers' は存在しません!したがって、間違ったエントリは、グループ'@users'に置き換えられました。もう一度インストールを実行して、別の値を入力してください。"
notifyGroupError="デスクトップメッセージのユーザーグループ'$notyfyUsers'が存在しない!したがって、間違ったエントリは '@users' に置き換えられました。もう一度インストールを実行して、別の値を入力してください。"
update_available="<span style='color:red'>GitHub で ${app_name} のアップデートが公開されています。</span> ${local_version} をバージョンに更新してください。"
txtAlertOnlyAdmin="administrators グループのメンバーのみアクセスが可能です。"
txtLanguageSource="このページの言語は、お使いのウェブブラウザの地域設定に従って選択されています。"
preinstDsmVersError="このパッケージのバージョンは DSM ${osMin} 以上でのみ使用可能です!DSM のバージョンによっては、これより前のバージョンのパッケージが使えるかもしれません。<a target='_blank' rel='noopener noreferrer' href='https://github.com/reidemei/synology-autorun#install'>https://github.com/reidemei/synology-autorun#install</a> を参照してください。"
details="詳細"
notAccepted="ライセンスは未受付です！"
