#!/bin/bash
# This file was generated via DeepL machine translation from en
# Filename: <lng>/lang.txt - coded in utf-8
# Language variables for cgi pages in the user language
# --------------------------------------------------------------
displaynameINFO="'displaynameINFO=\"Autorun\"''"
descriptionINFO="'descriptionINFO=\"Utför ett skript på en extern enhet (USB / eSATA) när den är ansluten till diskstationen.\"''"
LoginRequired="'LoginRequired=\"Login Required\"''"
PleaseLogin="'PleaseLogin=\"Vänligen logga in som administratör innan du använder den här webbsidan\"''"
settingsTitle="'settingsTitle=\"Aktuella inställningar för $app_name:\"''"
logTitleExec="'logTitleExec=\"Logg över åtgärder (anslutning av enhet, exekvering av skript och utskjutning av enhet)\"''"
logTitleDetail="'logTitleDetail=\"Debuglogg för aktiviteterna. Den faktiska loggnivån är '\''$LOGLEVEL'\'''\"''"
settingFingerprint="'settingFingerprint=\"Skriptet som körs med rotåtkomst är en säkerhetsrisk, särskilt om det är konfigurerat med plats på den externa lagringsenheten. Exekveringen kan begränsas till skript som matchar en tidigare registrerad SHA256-kontrollsumma.<br>0: Ingen begränsning. Tidigare registrerade kontrollsummor bevaras.<br>1: Om det finns tidigare registrerade kontrollsummor raderas de. Det första skriptet med dess kontrollsumma registreras som tillåten kontrollsumma.<br>2: Alla skript är tillåtna och deras kontrollsumma registreras.<br>3: Endast skript med tidigare registrerade kontrollsumma är tillåtna.\"''"
settingScript="'settingScript=\"Variant a: Skriptet finns i rotkatalogen på den externa lagringsenheten och är inställt som körbart för användaren '\''root'\'''. Det ges ett rent skriptnamn utan någon sökväg eller snedstreck.<br>Variant b: Skriptet ges med dess '\''s fullständiga sökväg och finns på NAS-enheten.<br>Det hämtar enhetens monteringspunkt (t.ex. /volumeUSB1/usbshare/) som den första parametern ($1) och enhetens partition (t.ex. usb1p1) som den andra ($2). Den måste vara körbar för '\''root'\'''. Den'\''startas med en tom miljö. Så som ingen PATH är inställd. Du måste för varje kommando använda den fullständiga sökvägen (t.ex. /bin/echo \"...\") eller ställa in PATH.\"''"
settingScriptAfter="'settingScriptAfter=\"Om skriptet avslutas med utgångskoden 100 kommer autorun att kasta ut lagringsenheten och därefter anropa det andra skriptet. Detta är valfritt. Typisk användning är att stänga av en hårddisk med extern strömförsörjning via en smart strömadapter.\"''"
settingTries="'settingTries=\"Tiden (i sekunder) hur länge autorun ska söka efter en monterad enhet. Öka det här värdet när du får felmeddelandet \"Kan inte hitta monteringspunkt\".\"''"
settingWait="'settingWait=\"En extra väntetid (i sekunder) efter att monteringen upptäcks innan skriptet startas. I vissa fall krävs en fördröjning på några sekunder för att få korrekt åtkomst till enheten.\"''"
settingBeep="'settingBeep=\"Om den är inställd på '\''true'\''', hörs ett kort pip när ett skript hittas. Och ett tredubbelt långt pip vid fel.\"''"
settingLedStatus="'settingLedStatus=\"Status-LED:n kan användas för att visa skriptets status.<br>0: Status-LED:n används av det här paketet.<br>1: 1: Grön när skriptet körs, grönt blinkande under utkastningen, OFF om det är klart med 0 eller 100, orange blinkande för andra resultat eller misslyckad utkastning<br/>2: Grönt blinkande när skriptet körs eller utkastas, grönt om det är klart med 0 eller 100, orange blinkande för andra resultat eller misslyckad utkastning<br/>3: Grönt när skriptet körs och under utkastningen, OFF när det är klart, orange blinkande om utkastningen misslyckades.\"''"
settingLedCopy="'settingLedCopy=\"Status-LED:n kan också användas för att visa skriptets status.<br>0: Kopierings-LED:n används av det här paketet.<br>1: Tänds under körning eller utskjutning, OFF efteråt<br/>2: Blinkar under körning eller utskjutning, OFF efteråt<br/>3: Tänds under körning eller utskjutning, OFF efteråt (0/100) eller blinkande (andra koder)<br/>4: Blinkar under körning eller utskjutning, OFF eller blinkande efteråt (andra koder eller utskjutning misslyckad)<br/>5: Blinkar under körning eller utskjutning, OFF (0/100) eller ON efteråt (andra koder eller utskjutning misslyckad)\"''"
settingNoDsmMessageReturnCodes="'settingNoDsmMessageReturnCodes=\"Normalt genereras ett DSM-skrivbordsmeddelande när skriptet är klart. Meddelandet innehåller skriptets returkod och det återstående lediga utrymmet på lagringsenheten. Om ditt skript avslutas med en av de koder som anges här genereras inget sådant meddelande. En post i paketets loggfil genereras ändå.\"''"
ledResetHint="'ledResetHint=\"Beroende på LED-inställningarna kan enhetens lysdioder visa ett feltillstånd efter att skriptet avslutats. Med kommandot <span style=\"font-family:'\''Courier New'\''\" translate='\''no'\''>echo 8 4 B> /dev/ttyS1</span>, som utförs som '\''root'\'', kan det normala tillståndet återställas. Du kan skapa en schemalagd uppgift i kontrollpanelen för ett anpassat skript för root-användaren med kommandot kör <span style=\"font-family:'\''Courier New'\'''\" translate='\''no'\''>echo 8 4 B> /dev/ttyS1</span> (8: Status-LED grön, 4: Strömbrytar-LED på, B: Kopiera-LED av). Och kör det om det är nödvändigt att återställa lysdioderna.\"''"
settingEjectTimeout="'settingEjectTimeout=\"Om den externa hårddisken inte kan skjutas ut vid utgångskod 100 (eftersom den är upptagen), ger detta en timeout i sekunder innan utmatningsförsöken avslutas med fel.\"''"
settingLogMaxLines="'settingLogMaxLines=\"För att undvika att loggfilerna tar upp för mycket utrymme raderas den äldsta halvan av filerna om antalet rader har nått det angivna antalet.\"'"
settingLogVerbose="'settingLogVerbose=\"Flera detaljeringsnivåer finns tillgängliga för att skriva meddelanden till felsökningsloggfilen: 1 ... 8. Ju högre värde desto mer detaljer.\"''"
settingNotifyUsers="'settingNotifyUsers=\"Paketet genererar skrivbordsmeddelanden som visas för en konfigurerbar användare eller användargrupp. Ett namn som börjar med '\''@'\''' är ett gruppnamn.\"''"
settingHeadlineFingerprints="'settingHeadlineFingerprints=\"Faktiskt registrerade SHA256-kontrollsummor (fingeravtryck) för skriptfiler:\"''"
runInstallationAgain="'runInstallationAgain=\"Du kan köra installationen igen för att ändra inställningarna eller radera kontrollsummorna!\"''"
ledCtrlHint="'ledCtrlHint=\"Om lysdioderna fortfarande visar ett fel kan du återställa dem här:\"''"
btnCopyLedOff="'btnCopyLedOff=\"Copy LED OFF\"''"
btnStatusLedGreen="'btnStatusLedGreen=\"Status LED grön\"''"
btnStatusLedOff="'btnStatusLedOff=\"Status LED OFF\"''"
btnDelLog="'btnDelLog=\"Ta bort den här loggfilen\"''"
btnRefresh="'btnRefresh=\"Uppdatera sidan\"''"
btnShowDetailLog="'btnShowDetailLog=\"Visa detaljerad felsökningsloggfil\"''"
btnShowSimpleLog="'btnShowSimpleLog=\"Visa enkel logg\"''"
hrefLog="'hrefLog=\"Logg över åtgärder\"''"
btnShowLicence="'btnShowLicence=\"Licence\"''"
btnShowSettings="'btnShowSettings=\"Visa inställningar\"''"
btnDownload="'btnDownload=\"Ladda ner ...\"''"
execLogNA="'execLogNA=\"Loggfilen finns inte eller är tom. Fanns det redan en lagringsenhet med en skriptfil i rotmappen som var ansluten efter start av detta paket?\"''"
HASH_DELETION="'HASH_DELETION=\"<b>Förra registrerade hashkoder är alla raderade nu.</b> \"''"
copyPriviledge="'copyPriviledge=\"Du kan utföra det nödvändiga kommandot <input type='\''text'\'' size='\''80'\'' value='\''sudo cp /var/packages/$SYNOPKG_PKGNAME/conf/privilege.root /var/packages/$SYNOPKG_PKGNAME/conf/privilege'\''> via SSH (eller schemalagd uppgift)<strong>nu!</strong> Efter '\''OK'\''' kan du sedan starta paketet med '\''Kör'\''.\"''"
scriptNA="'scriptNA=\"Fel: Skriptet '\''$f'\''' kunde inte hittas!\"''"
scriptNAcase="'scriptNAcase=\"Misstänkt: Fil med olika stora/små bokstäver hittad!\"''"
setupCorrection="'setupCorrection=\"Det är möjligt att du måste köra installationen igen för att korrigera inställningen!\"''"
scriptNexec="'scriptNexec=\"Fel: Skriptet '\''$f'\''' är inte körbart!\"''"
wrongLineBreakWin="'wrongLineBreakWin=\"Fel: Skriptet '\''$f'\''', som ska utföras, använder fel radbrytning CR/LF (Windows). Använd en siutable Editor (Linux oder Windows Notepad  , PSPad, ...) för att ändra det till LF (UNIX)!\"''"
wrongCodePage="'wrongCodePage=\"Fel: Skriptet '\''$f'\''', som borde utföras, använder fel kodning (Windows ISO-8859). Använd en siutable Editor (Linux oder Windows Notepad  , PSPad, ...) för att ändra den till UTF-8!\"''"
wrongLineBreakMac="'wrongLineBreakMac=\"Fel: Skriptet '\''$f'\''', som borde exekveras, använder fel radbrytare (MAC). Använd en siutable Editor för att ändra det till LF (UNIX)!\"''"
notifyUserError="'notifyUserError=\"Användarkontot '\''$notyfyUsers'\'' för skrivbordsmeddelanden finns inte! Därför har fel post ersatts av gruppen '\''@users'\'''. Kör installationen igen för att ange ett annat värde!\"''"
notifyGroupError="'notifyGroupError=\"Användargruppen '\''$notyfyUsers'\'' för skrivbordsmeddelanden finns inte! Därför har fel post ersatts av '\''@users'\'''. Kör installationen igen för att ange ett annat värde!\"''"
update_available="'update_available=\"<span style='\''color:red'\''>En uppdatering av ${app_name} är tillgänglig på GitHub.</span> Uppdatera din version ${local_version} till version\"''"
txtAlertOnlyAdmin="'txtAlertOnlyAdmin=\"Endast medlemmar av gruppen administratörer har rätt till åtkomst\"''"
txtLanguageSource="'txtLanguageSource=\"Språket på den här sidan valdes enligt din webbläsares regionala inställningar.\"''"
preinstDsmVersError="'preinstDsmVersError=\"Den här paketversionen kan endast användas i DSM ${osMin} och högre! Tidigare paketversioner kan vara möjliga i din DSM-version, se <a target='\''_blank'\'' rel='\''noopener noreferrer'\'' href='\''https://github.com/reidemei/synology-autorun#install'\''>https://github.com/reidemei/synology-autorun#install</a>\"''"

