#!/bin/bash
# This file was generated via DeepL machine translation from en
# Filename: <lng>/lang.txt - coded in utf-8
# Language variables for cgi pages in the user language
# --------------------------------------------------------------
displaynameINFO="Autorun"
descriptionINFO="Ejecuta una secuencia de comandos en/para una unidad externa (USB / eSATA) después de conectarla a la Disk Station."
LoginRequired="Inicio de sesión obligatorio"
PleaseLogin="Por favor, inicie sesión como administrador antes de utilizar esta página web"
settingsTitle="Configuración real de $nombre_de_la_aplicación:"
logTitleExec="Registro de acciones (fijación de dispositivos, ejecución de scripts y expulsión de dispositivos)"
logTitleDetail="Registro de depuración de las actividades. El nivel de registro real es '$LOGLEVEL'"
settingFingerprint="El con acceso de root script ejecutado es un riesgo de seguridad, especialmente si está configurado con ubicación en el almacenamiento externo. Se puede restringir la ejecución a los scripts que coincidan con las sumas de comprobación SHA256 previamente registradas.<br>0: No hay restricción. Las sumas de comprobación previamente registradas se conservan.<br>1: Si hay sumas de comprobación previamente registradas, se eliminan. El primer script con su suma de comprobación se registra como suma de comprobación permitida.<br>2: Se permiten todos los scripts y se registran sus sumas de comprobación, si no se han registrado antes.<br>3: Sólo se permiten los scripts con sumas de comprobación previamente registradas."
settingSecurityWarning="<span style=\"color:red\"><b>Atención:</b></span> Combinar la variante de script a) (script en dispositivo USB/eSATA externo) con la configuración de huella digital 0 o 2 puede ser un riesgo de seguridad crítico: Los scripts con contenido arbitrario en el dispositivo de almacenamiento externo se ejecutan al enchufarlo y ¡tienen acceso a todo! Conectarlo puede ser suficiente para destruir o robar los datos de su Synology NAS."
settingScript="Variante a: La secuencia de comandos se encuentra en el directorio raíz del dispositivo de almacenamiento externo y se establece como ejecutable para el usuario 'root'. Se proporciona el nombre de la secuencia de comandos sin ninguna ruta ni barra.<br>Variante b: La secuencia de comandos se proporciona con su ruta completa y se encuentra en el NAS.<br>Obtiene el punto de montaje del dispositivo (por ejemplo, /volumeUSB1/usbshare/) como primer parámetro (\$1) y la partición del dispositivo (por ejemplo, usb1p1) como segundo parámetro (\$2). Tiene que ser ejecutable para 'root'. Para 'root' es en DSM 7 el shell 'ash' utilizado. Pero /bin/ash puede ser un enlace a 'bash' (al menos en un DS220 ). El script se inicia con un entorno vacío. Así que no se establece ningún PATH. Tienes que usar para cada comando la ruta completa (ej. /bin/echo \"...\", /bin/printf ...). Su script puede detenerse con el código de salida 2 si no se encuentra un comando debido a que falta una ruta. En las primeras líneas de tu script, puedes usar un 'unset PATH' para tener en las ejecuciones de depuración del script las mismas condiciones. O añade una línea como 'PATH=/sbin:/bin:/usr/sbin:/usr/bin:/usr/syno/sbin:/usr/syno/bin:/usr/local/sbin:/usr/local/bin' al principio de tu script."
settingScriptAfter="Si el script sale con algunos códigos de salida definidos, entonces autorun expulsará ese dispositivo de almacenamiento y después llamará a este segundo script. Esto es opcional. El uso típico es apagar un disco duro con alimentación externa a través de un adaptador de corriente inteligente."
settingTries="El tiempo (en segundos) que autorun debe buscar una unidad montada. Aumente este valor cuando obtenga el error \"no se puede encontrar el punto de montaje\"."
settingWait="Se detecta un tiempo de espera adicional (en segundos) después del montaje antes de iniciar el script. En algunos casos se requiere un retraso de unos segundos para el acceso correcto a la unidad."
settingBeep="Si se establece en 'true', hay un pitido corto cuando se encuentra un script. Y un triple pitido largo en caso de error."
settingLedStatus="El LED de estado se puede utilizar para mostrar el estado del script.<br>0: El LED de estado no es utilizado por este paquete.<br>1: 1: Verde mientras se ejecuta, verde parpadeante durante la expulsión, apagado si finaliza con 0 o uno de los códigos definidos para la expulsión, naranja parpadeante para otros resultados o expulsión fallida<br/>2: Verde parpadeante mientras el script se ejecuta o expulsa, verde si finaliza con 0 o uno de los códigos definidos para la expulsión, naranja parpadeante para otros resultados o expulsión fallida<br/>3: Verde mientras el script se ejecuta y durante la expulsión, apagado cuando finaliza, naranja parpadeante si la expulsión falló."
settingLedCopy="El LED de estado también se puede utilizar para mostrar el estado del script.<br>0: El LED de copia no es utilizado por este paquete.<br>1: ON mientras se ejecuta o expulsa, OFF después<br/>2: Parpadeando mientras se ejecuta o expulsa, OFF después<br/>3: ON mientras se ejecuta o expulsa, OFF después (0 o uno de los códigos con expulsión) o parpadeando (otros códigos)<br/>4: Intermitente en marcha o expulsión, después OFF o intermitente (otros códigos o fallo expulsión)<br/>5: Intermitente en marcha o expulsión, después OFF (0 o uno de los códigos con expulsión) u ON (otros códigos o fallo expulsión)."
settingNoDsmMessageReturnCodes="Normalmente hay un mensaje de escritorio DSM generado después de que su script haya terminado. El mensaje contiene el código de retorno de su script y el espacio libre restante en el dispositivo de almacenamiento. Si su script sale con uno de los códigos dados aquí, entonces no se genera dicho mensaje. De todas formas, se genera una entrada en el archivo de registro del paquete."
settingEjectTimeout="Si en el caso de un código de salida configurado para la expulsión del dispositivo la unidad externa no puede ser expulsada (ya que está ocupada), esto da el tiempo de espera en segundos antes de terminar los intentos de expulsión con error."
settingLogMaxLines="Para evitar que los archivos de registro ocupen demasiado espacio, la mitad superior de los archivos se elimina si el recuento de líneas ha alcanzado el número indicado."
settingLogVerbose="Existen varios niveles de detalle para escribir mensajes en el archivo de registro de depuración: 1 ... 8. Cuanto más alto sea el valor, más detalles."
settingNotifyUsers="El paquete genera notificaciones de escritorio, que se muestran a un usuario o grupo de usuarios configurable. Un nombre que empieza por '@' es un nombre de grupo, por lo que se muestra a todos esos miembros.<br>Consejos:<br>Los administradores también son miembros del grupo <code>@users</code>.<br>Con el comando <code>/usr/syno/bin/synodsmnotify -c \\"SYNO.SDS._ThirdParty.App.autorun\\" \\"@users\\" \\"autorun:app1:title02\\" \autorun:app1:msg0\" \\"\<Tu texto de mensaje\>\"</code> puedes generar mensajes adicionales desde dentro de tus scripts."
settingHeadlineFingerprints="Sumas de comprobación SHA256 registradas actualmente (huellas dactilares) de archivos de script:"
settingCapture="La salida a stdout de su script (o scripts) se puede insertar en el log de Autorun:<br>0: La salida no se captura.<br>1: La salida se inserta en el log de acción principal de Autorun.<br>2: La salida se inserta en el log de depuración."
settingsEjectReturnCodes="Su script puede salir con un código de retorno 0 ... 255. Puede especificar algunos códigos de retorno o rangos de códigos de retorno para los que se expulsa el dispositivo de almacenamiento externo una vez finalizado el script."
settingFailureCodes="Lista de códigos de salida de la secuencia de comandos, que se consideran como un fallo y posiblemente señalados por los LED o la señal acústica."
settingCGIDEBUG="empty&gt;: La ejecución de index.cgi y settings.cgi no genera entradas de registro de depuración.<br>checked: La ejecución de index.cgi y settings.cgi genera entradas de registro de depuración. Esto puede ser confuso durante la depuración de otros problemas."
runInstallationAgain="Puede volver a ejecutar la instalación para cambiar la configuración o eliminar las sumas de comprobación."
ledCtrlHint="Si la indicación de los LEDs sigue siendo un error, se puede restablecer aquí:"
btnLedOff="OFF"
btnLedOn="EN"
btnStatusLedGreen="Verde"
labelStatusLed="LED de estado"
labelCopyLed="Copiar LED"
btnLedFlash="intermitente"
btnLedGreenFlash="Verde intermitente"
btnLedOrangeFlash="Naranja intermitente"
btnLedOrange="naranja"
btnDelLog="Eliminar este archivo de registro"
btnRefresh="Actualizar la página"
btnShowDetailLog="Mostrar el archivo de registro de depuración detallado"
btnShowSimpleLog="Mostrar archivo de registro de acciones"
hrefLog="Registro de acciones"
btnShowLicence="Licencia"
btnShowSettings="Mostrar la configuración"
btnDownload="Descargar ..."
execLogNA="Archivo de registro no encontrado o vacío. ¿Ha habido algún evento que registrar desde el lanzamiento?"
HASH_DELETION="<b>Los hashtags registrados anteriormente se han borrado todos.</b>"
copyPrivilege="<strong>Importante:</strong> Como los paquetes de terceros están restringidos por Synology en DSM 7.x, se requiere un paso más para finalizar la instalación y poder ejecutar el paquete:<br>Es necesario ejecutar el siguiente comando: <input type='text' size='80' value='sudo cp /var/packages/\$SYNOPKG_PKGNAME/conf/privilege.root /var/packages/\$SYNOPKG_PKGNAME/conf/privilege'> <strong>Posibilidad 1:</strong><br>Abra un shell de comandos SSH en su NAS (como usuario administrador) y ejecute el comando anterior. Después de eso continúe y <strong>Ejecute</strong> el paquete.<br><strong>Posibilidad 2:</strong><br>Pista: Si ya ha hecho esto antes, puede saltar al paso 2.2.<br>2.1.</strong>: Vaya ahora en el panel de control al 'Programador de tareas' y cree una tarea programada con un script definido por el usuario. En la pestaña general establezca un nombre útil y seleccione 'root' como usuario. Como 'Programar' puedes seleccionar una fecha en el pasado y la opción 'No repetir'. En la 'Configuración de tareas' copie y pegue el comando anterior como 'Script definido por el usuario'. Finalice la configuración de la tarea y confirme la advertencia: Seleccione la tarea generada y <strong>ejecútela</strong>.<br>2.3: Cierre el Panel de Control y también este diálogo aquí. Vaya al Centro de Paquetes, a la sección 'Paquetes instalados', seleccione el paquete Autorun y <strong>ejecútelo</strong>."
scriptNA="Error: ¡El Skript '$f' no pudo ser encontrado!"
scriptNAcase="Sospechoso: ¡Fichero con diferentes mayúsculas y minúsculas encontrado!"
setupCorrection="Posiblemente tenga que volver a ejecutar la instalación para corregir la configuración."
scriptNexec="Error: ¡El Skript '$f' no es ejecutable!"
wrongLineBreakWin="Error: El Skript '$f', que debería ser ejecutado, utiliza un salto de línea CR/LF incorrecto (Windows). ¡Por favor, utilice un editor siutable (Linux oder Windows Notepad  , PSPad, ...) para cambiarlo a LF (UNIX)!"
wrongCodePage="Error: El Skript '$f', que debería ser ejecutado, utiliza una codificación incorrecta (Windows ISO-8859). ¡Por favor, utilice un editor siutable (Linux oder Windows Notepad  , PSPad, ...) para cambiarlo a UTF-8!"
wrongLineBreakMac="Error: El Skript '$f', que debería ser ejecutado, utiliza el salto de línea CR (MAC) incorrecto. Por favor, utilice un editor siutable para cambiarlo por LF (UNIX)."
notifyUserError="¡La cuenta de usuario '$notyfyUsers' para mensajes de escritorio no existe! Por lo tanto, la entrada errónea sustituida por el grupo '@users'. ¡Ejecute la instalación de nuevo para introducir otro valor!"
notifyGroupError="¡El grupo de usuarios '$notyfyUsers' para mensajes de escritorio no existe! Por lo tanto, la entrada errónea sustituida por '@users'. Ejecute la instalación de nuevo para introducir otro valor."
update_available="<span style='color:red'>Una actualización de ${app_name} está disponible en GitHub.</span> Por favor, actualice su versión ${local_version} a la versión"
txtAlertOnlyAdmin="El acceso sólo está permitido a los miembros del grupo de administradores"
txtLanguageSource="El idioma de esta página fue seleccionado de acuerdo a la configuración regional de su navegador."
preinstDsmVersError="¡Esta versión del paquete sólo se puede utilizar en DSM ${osMin} y superior! Versiones anteriores del paquete pueden ser posibles en su versión de DSM, ver <a target='_blank' rel='noopener noreferrer' href='https://github.com/reidemei/synology-autorun#install'>https://github.com/reidemei/synology-autorun#install</a>"
details="Detalles"
notAccepted="Todavía no se acepta la licencia"
