#!/bin/bash
# This file was generated via DeepL machine translation from en
# Filename: <lng>/lang.txt - coded in utf-8
# Language variables for cgi pages in the user language
# --------------------------------------------------------------
displaynameINFO="'displaynameINFO=\"Autorun\"'"
descriptionINFO="'descriptionINFO=\"Wykonuje skrypt na dysku zewnętrznym (USB / eSATA), gdy jest on podłączony do stacji dysków.\""
LoginRequired="'LoginRequired=\"Login Required\"'"
PleaseLogin="'PleaseLogin=\"Proszę najpierw zalogować się jako administrator, przed skorzystaniem z tej strony\"'"
settingsTitle="'settingsTitle=\"Actual $app_name Settings:\"'"
logTitleExec="'logTitleExec=\"Dziennik działań (dołączenie urządzenia, wykonanie skryptu i wysunięcie urządzenia)\""
logTitleDetail="'logTitleDetail=\"Dziennik debugowania działań. Rzeczywisty poziom dziennika to '$LOGLEVEL'\\""
settingFingerprint="'settingFingerprint=\"Wykonywany skrypt z dostępem roota stanowi zagrożenie bezpieczeństwa, zwłaszcza jeśli jest skonfigurowany z lokalizacją na zewnętrznej pamięci masowej. Wykonanie może być ograniczone do skryptów pasujących wcześniej zarejestrowanych sum kontrolnych SHA256.<br>0: Brak ograniczeń. Wcześniej zarejestrowane sumy kontrolne są zachowane.<br>1: Jeśli istnieją wcześniej zarejestrowane sumy kontrolne, są one usuwane. Pierwszy skrypt z jego sumy kontrolnej jest zarejestrowany jako dozwolone sumy kontrolnej.<br>2: Wszystkie skrypty są dozwolone i tam sumy kontrolne są rejestrowane.<br>3: Tylko skrypty z wcześniej zarejestrowanych sum kontrolnych są dozwolone.\""
settingScript="'settingScript=\"Wariant a: Skrypt znajduje się w katalogu głównym zewnętrznego urządzenia pamięci masowej i jest ustawiony jako wykonywalny dla użytkownika 'root'\\". Podana jest czysta nazwa skryptu bez ścieżki lub ukośnika.<br>Wariant b: Skrypt jest podany z pełną ścieżką i znajduje się na NAS.<br>Pobiera punkt montowania urządzenia (np. /volumeUSB1/usbshare/) jako pierwszy parametr ($1) i partycji urządzenia (np. usb1p1) jako drugi ($2). Musi być wykonywalny dla 'root'a'. Jest on uruchamiany z pustym środowiskiem. Więc nie ma ustawionej PATH. Trzeba użyć dla każdego polecenia pełnej ścieżki (np. /bin/echo \"...\") lub ustawić PATH.\""
settingScriptAfter="'settingScriptAfter=\"Jeżeli skrypt zakończy się kodem wyjścia 100, to autorun wyrzuci urządzenie pamięci masowej i następnie wywoła ten drugi skrypt. Jest to opcjonalne. Typowym zastosowaniem jest wyłączenie dysku twardego z zewnętrznym zasilaniem za pomocą inteligentnego zasilacza.\"'"
settingTries="'settingTries=\"Czas (w sekundach) jak długo autorun powinien szukać zamontowanego dysku. Zwiększ tę wartość, gdy otrzymasz błąd \"unable to find mount point\".\""
settingWait="'settingWait=\"Dodatkowy czas oczekiwania (w sekundach) po wykryciu montażu przed uruchomieniem skryptu. W niektórych przypadkach kilkusekundowe opóźnienie jest wymagane do prawidłowego dostępu do dysku.\"'"
settingBeep="'settingBeep=\"Jeśli ustawione na 'true', to po znalezieniu skryptu następuje krótki sygnał dźwiękowy. I potrójny długi sygnał dźwiękowy w przypadku błędu.\"'"
settingLedStatus="'settingLedStatus=\"Dioda LED statusu może być użyta do pokazania statusu skryptu.<br>0: Dioda LED statusu jest używana przez ten pakiet.<br>1: 1: Zielona podczas pracy, zielona migająca podczas wysuwania, WYŁĄCZONA jeśli zakończona z 0 lub 100, pomarańczowa migająca dla innych wyników lub nieudanego wysuwania<br/>2: Zielona migająca podczas pracy skryptu lub wysuwania, zielona jeśli zakończona z 0 lub 100, pomarańczowa migająca dla innych wyników lub nieudanego wysuwania<br/>3: Zielona podczas pracy skryptu i podczas wysuwania, WYŁĄCZONA jeśli zakończona, pomarańczowa migająca jeśli wysuwanie nie powiodło się.\""
settingLedCopy="'settingLedCopy=\"Dioda LED statusu może być również używana do pokazywania statusu skryptu.<br>0: Dioda LED kopii jest używana przez ten pakiet.<br>1: Włączona podczas biegu lub wysuwania, wyłączona po tym<br/>2: Migająca podczas biegu lub wysuwania, wyłączona po tym<br/>3: Włączona podczas biegu lub wysuwania, po tym wyłączona (0/100) lub migająca (inne kody)<br/>4: Migająca podczas biegu lub wysuwania, po tym wyłączona lub migająca (inne kody lub wysuwanie nieudane)<br/>5: Migająca podczas biegu lub wysuwania, po tym wyłączona (0/100) lub włączona (inne kody lub wysuwanie nieudane)\""
settingNoDsmMessageReturnCodes="'settingNoDsmMessageReturnCodes=\"Normalnie po zakończeniu skryptu generowany jest komunikat pulpitu DSM. Komunikat zawiera kod powrotu Twojego skryptu i pozostałą wolną przestrzeń na urządzeniu pamięci masowej. Jeśli skrypt kończy pracę z jednym z podanych tutaj kodów, to taki komunikat nie jest generowany. Nadal generowany jest wpis w pliku dziennika pakietu.\"'"
ledResetHint="'ledResetHint=\"W zależności od ustawień diod LED, diody na urządzeniu mogą wskazywać stan błędu po zakończeniu skryptu. Za pomocą polecenia <span style=\"font-family: \"Courier New\"\\" translate=\"no\"\\" >echo 8 4 B> /dev/ttyS1</span>, wykonywanego jako \"root\"\\", można przywrócić normalny stan. Możesz stworzyć zaplanowane zadanie w panelu sterowania dla niestandardowego skryptu dla użytkownika root z poleceniem run <span style=\"font-family:'\\"Courier New'\\" translate='\\"no'\\" >echo 8 4 B> /dev/ttyS1</span> (8: Status LED zielony, 4: Power LED włączony, B: Copy LED wyłączony). I uruchom to, jeśli konieczne jest zresetowanie diod LED.\""
settingEjectTimeout="'settingEjectTimeout=\"Jeśli w przypadku kodu wyjścia 100 dysk zewnętrzny nie może być wysunięty (ponieważ jest zajęty), to podaje czas oczekiwania w sekundach przed zakończeniem próby wysunięcia z błędem.\""
settingLogMaxLines="'settingLogMaxLines=\"Aby uniknąć, że zbyt wiele miejsca zajmują pliki dziennika, starsza połowa plików jest usuwana, jeśli liczba linii osiągnęła podaną liczbę.\""
settingLogVerbose="'settingLogVerbose=\"Przy zapisywaniu komunikatów do pliku dziennika debugowania dostępnych jest kilka poziomów szczegółowości: 1 ... 8. Im wyższa wartość tym więcej szczegółów.\"'"
settingNotifyUsers="'settingNotifyUsers=\"Pakiet generuje powiadomienia na pulpicie, które są wyświetlane konfigurowalnemu użytkownikowi lub grupie użytkowników. Nazwa rozwarstwiająca się na '@'ą' jest nazwą grupy.\""
settingHeadlineFingerprints="'settingHeadlineFingerprints=\"Aktualnie zarejestrowane sumy kontrolne SHA256 (fingerprints) plików skryptów:\""
runInstallationAgain="'runInstallationAgain=\"Możesz uruchomić instalację ponownie, aby zmienić ustawienia lub usunąć sumy kontrolne!\""
ledCtrlHint="'ledCtrlHint=\"Jeśli wskazanie diod LED nadal jest błędem, można je zresetować tutaj:\""
btnCopyLedOff="'btnCopyLedOff=\"Copy LED OFF\"'"
btnStatusLedGreen="'btnStatusLedGreen=\"Status LED zielony\"'"
btnStatusLedOff="'btnStatusLedOff=\"Status LED OFF\"'"
btnDelLog="'btnDelLog=\"Usuń ten plik dziennika\"'"
btnRefresh="'btnRefresh=\"Odśwież stronę\"'"
btnShowDetailLog="'btnShowDetailLog=\"Pokaż szczegółowy plik dziennika debugowania\"'"
btnShowSimpleLog="'btnShowSimpleLog=\"Pokaż prosty dziennik\"'"
hrefLog="'hrefLog=\"Dziennik działań\"'"
btnShowLicence="'btnShowLicence=\"Licencja\"'"
btnShowSettings="'btnShowSettings=\"Pokaż ustawienia\"'"
btnDownload="'btnDownload=\"Pobierz ...\"'"
execLogNA="'execLogNA=\"Logfile not found or empty. Czy po uruchomieniu tego pakietu było już podłączone urządzenie magazynowe z plikiem skryptu w folderze głównym?\""
HASH_DELETION="'HASH_DELETION=\"<b>Poprzednie zarejestrowane hashe są teraz wszystkie usunięte.</b> \""
copyPriviledge="'copyPriviledge=\"Możesz wykonać wymagane polecenie <input type='text'™' size='80'™' value='sudo cp /var/packages/$SYNOPKG_PKGNAME/conf/privilege.root /var/packages/$SYNOPKG_PKGNAME/conf/privilege'\\" > przez SSH (lub zaplanowane zadanie)<strong>teraz!</strong>Po 'OK'\' można następnie uruchomić pakiet za pomocą 'Run'\'."
scriptNA="'scriptNA=\"Błąd: Skrypt '$f' nie mógł zostać znaleziony!\""
scriptNAcase="'scriptNAcase=\"Podejrzane: znaleziono plik z różnymi dużymi/małymi literami!\""
setupCorrection="'setupCorrection=\"Możliwe, że musisz uruchomić instalację ponownie, aby poprawić ustawienia!\""
scriptNexec="'scriptNexec=\"Error: Skrypt '$f' nie jest wykonywalny!\""
wrongLineBreakWin="'wrongLineBreakWin=\"Błąd: Skrypt '$f'\\", który powinien zostać wykonany, używa nieprawidłowego podziału linii CR/LF (Windows). Proszę użyć edytora siutable (Linux oder Windows Notepad  , PSPad, ...) aby zmienić go na LF (UNIX)!\"'"
wrongCodePage="'wrongCodePage=\"Błąd: Skrypt '$f', który powinien zostać wykonany, używa nieprawidłowego kodowania (Windows ISO-8859). Proszę użyć siutable Editor (Linux oder Windows Notepad  , PSPad, ...), aby zmienić go na UTF-8!\"'"
wrongLineBreakMac="'wrongLineBreakMac=\"Błąd: Skrypt '$f', który powinien zostać wykonany, używa niewłaściwego podziału linii CR (MAC). Proszę użyć edytora siutable, aby zmienić go na LF (UNIX)!\"'"
notifyUserError="'notifyUserError=\"Konto użytkownika '$notyfyUsers'\\" dla wiadomości na pulpicie nie istnieje! Dlatego błędny wpis zastąpiony przez grupę '\u0026apos; @users'\u0026apos;. Uruchom Instalację ponownie, aby wprowadzić inną wartość!\""
notifyGroupError="'notifyGroupError=\"Grupa użytkowników '$notyfyUsers'\\" dla wiadomości na pulpicie nie istnieje! W związku z tym błędny wpis zastąpiony przez '\\"@users'\\". Uruchom Instalację ponownie, aby wprowadzić inną wartość!\""
update_available="'update_available=\"<span style=\"color:red\">A ${app_name}aktualizacja jest dostępna na GitHub.</span> Proszę zaktualizować swoją wersję ${local_version}do wersji\""
txtAlertOnlyAdmin="'txtAlertOnlyAdmin=\"Dostęp jest dozwolony tylko dla członków od grupy administratorów\"'"
txtLanguageSource="'txtLanguageSource=\"Język tej strony został wybrany zgodnie z ustawieniami regionalnymi Twojej przeglądarki internetowej.\""
preinstDsmVersError="'preinstDsmVersError=\"Ta wersja pakietu może być używana tylko w DSM ${osMin} i wyżej! Wcześniejsze wersje pakietów mogą być możliwe na twojej wersji DSM, zobacz <a target='_blank'\\" rel='\\"noopener noreferrer'\\" href='\\"https://github.com/reidemei/synology-autorun#install'\\" >https://github.com/reidemei/synology-autorun#install</a>"

