#!/bin/bash
# This file was generated via DeepL machine translation from en
# Filename: <lng>/lang.txt - coded in utf-8
# Language variables for cgi pages in the user language
# --------------------------------------------------------------
displaynameINFO="\"displaynameINFO=\"Autorun\""
descriptionINFO="descriptionINFO=\"Voert een script uit op externe schijf (USB / eSATA) wanneer deze is aangesloten op het schijfstation.\""
LoginRequired="\"LoginRequired=\"Login Verplicht\""
PleaseLogin="'PleaseLogin=\"Log eerst in als admin, voordat u deze webpagina gebruikt\"'"
settingsTitle="settingsTitle=\"Actuele $app_name Instellingen:\""
logTitleExec="\"logTitleExec=\"Log van acties (vastmaken van apparaat, uitvoeren van script en uitwerpen van apparaat)\""
logTitleDetail="'logTitleDetail=\"Debug Log van de activiteiten. Huidig logniveau is '\''$LOGLEVEL'\'\""
settingFingerprint="settingFingerprint=\"Het met root-toegang uitgevoerde script is een veiligheidsrisico, vooral als het is geconfigureerd met locatie op de externe opslag. Uitvoering kan worden beperkt tot scripts die overeenkomen met eerder geregistreerde SHA256 controlesom.<br>0: Geen beperking. Eerder geregistreerde controlesommen blijven behouden.<br>1: Als er eerder geregistreerde controlesommen zijn, worden ze verwijderd. Het eerste script met zijn controlesom wordt geregistreerd als toegestane controlesom.<br>2: Alle scripts zijn toegestaan en hun controlesommen worden geregistreerd.<br>3: Alleen scripts met eerder geregistreerde controlesommen zijn toegestaan."
settingScript="'settingScript=\"Variant a: Het script bevindt zich in de hoofdmap van het externe opslagapparaat en is ingesteld als uitvoerbaar voor de gebruiker '\root'. Het script wordt gegeven met het volledige pad en bevindt zich op de NAS.<br>Het krijgt het koppelpunt van het apparaat (bijv. /volumeUSB1/usbshare/) als eerste parameter ($1) en de apparaatpartitie (bijv. usb1p1) als tweede ($2). Het moet uitvoerbaar zijn voor 'root'. Het wordt gestart met een lege omgeving. Dus er is geen PATH ingesteld. Je moet voor elk commando het volledige pad gebruiken (bijv. /bin/echo \"...\") of het PATH instellen.''"
settingScriptAfter="settingScriptAfter=\"Als het script wordt afgesloten met de exit code 100, dan zal autorun dat opslagapparaat uitwerpen en daarna dit 2de script aanroepen. Dit is optioneel. Typisch gebruik is het uitschakelen van een HDD met externe voeding via een slimme stroomadapter.\""
settingTries="'settingTries=\"De tijd (in seconden) hoe lang autorun moet zoeken naar een aangekoppeld station. Verhoog deze waarde wanneer u de \"unable to find mount point\" foutmelding krijgt.\""
settingWait="'settingWait=\"Een extra wachttijd (in seconden) na het mounten wordt gedetecteerd voordat het script wordt gestart. In sommige gevallen is een vertraging van enkele seconden nodig voor goede toegang tot de schijf.\""
settingBeep="'settingBeep=\"Indien ingesteld op 'waar' is er een korte piep als er een script wordt gevonden. En een driedubbele lange piep bij een fout.\""
settingLedStatus="'settingLedStatus=\"De status LED kan worden gebruikt om de status van het script weer te geven.<br>0: De status LED wordt gebruikt door dit pakket.<br>1: 1: Groen terwijl het script loopt, groen knipperend tijdens het uitwerpen, UIT als het klaar is met 0 of 100, oranje knipperend voor andere resultaten of mislukt uitwerpen<br/>2: Groen knipperend terwijl het script loopt of uitgeworpen wordt, groen als het klaar is met 0 of 100, oranje knipperend voor andere resultaten of mislukt uitwerpen<br/>3: Groen terwijl het script loopt en tijdens het uitwerpen, UIT als het klaar is, oranje knipperend als het uitwerpen mislukt.\""
settingLedCopy="settingLedCopy=\"De status-LED kan ook worden gebruikt om de status van het script weer te geven.<br>0: De kopie-LED wordt gebruikt door dit pakket.<br>1: AAN tijdens het draaien of uitwerpen, daarna UIT<br/>2: Knipperen tijdens het draaien of uitwerpen, daarna UIT<br/>3: AAN tijdens het draaien of uitwerpen, daarna UIT (0/100) of knipperen (andere codes)<br/>4: Knipperen tijdens het draaien of uitwerpen, daarna UIT of knipperen (andere codes of uitwerpfalen)<br/>5: Knipperen tijdens het draaien of uitwerpen, daarna UIT (0/100) of AAN (andere codes of uitwerpfalen)\""
settingNoDsmMessageReturnCodes="settingNoDsmMessageReturnCodes=\"Normaal gesproken wordt er een DSM-desktopbericht gegenereerd nadat je script is beëindigd. Het bericht bevat de retourcode van je script en de resterende vrije ruimte op het opslagapparaat. Als je script eindigt met een van de hier gegeven codes, dan wordt zo'n bericht niet gegenereerd. Er wordt nog steeds een vermelding in het logbestand van het pakket gegenereerd.\""
ledResetHint="'ledResetHint=\"Afhankelijk van de LED-instellingen kunnen de LED's op het apparaat een fouttoestand aangeven nadat het script is afgelopen. Met het commando <span style=\"font-family:'\'Courier New'\'\" translate='\'no'\''>echo 8 4 B> /dev/ttyS1</span>, uitgevoerd als '\root'\', kan de normale toestand worden hersteld. U kunt in het configuratiescherm een geplande taak maken voor een aangepast script voor de root-gebruiker met de opdracht <span style=\"font-family:'\Courier New'\'\" translate='\no'\''>echo 8 4 B> /dev/ttyS1</span> (8: Status LED groen, 4: Power LED aan, B: Copy LED uit). En voer dat uit als het nodig is om de LED's te resetten.''"
settingEjectTimeout="settingEjectTimeout=\"Als in geval van exit code 100 de externe schijf niet kan worden uitgeworpen (omdat deze bezet is), geeft dit de time-out in seconden voordat de uitwerppogingen met een fout worden beëindigd.\""
settingLogMaxLines="settingLogMaxLines=\"Om te voorkomen dat de logbestanden te veel ruimte innemen, wordt de oudere helft van de bestanden verwijderd als het aantal regels het opgegeven aantal heeft bereikt.\""
settingLogVerbose="settingLogVerbose=\"Er zijn verschillende detailniveaus beschikbaar voor het schrijven van berichten naar het debug-logbestand: 1 ... 8. Hoe hoger de waarde, hoe meer details.\""
settingNotifyUsers="'settingNotifyUsers=\"Het pakket genereert bureaubladmeldingen, die worden getoond aan een configureerbare gebruiker of gebruikersgroep. Een naam die begint met '@'\' is een groepsnaam.\""
settingHeadlineFingerprints="settingHeadlineFingerprints=\"Actueel geregistreerde SHA256 checksums (vingerafdrukken) van scriptbestanden:\""
runInstallationAgain="\"runInstallationAgain=\"U kunt de installatie opnieuw uitvoeren om de instellingen te wijzigen of de controlesommen te verwijderen!\""
ledCtrlHint="'ledCtrlHint=\"Als de LED indicatie nog steeds een fout aangeeft, kun je het hier resetten:\""
btnCopyLedOff="\"btnCopyLedOff=\"Copy LED OFF\""
btnStatusLedGreen="\"btnStatusLedGreen=\"Status-LED groen\""
btnStatusLedOff="\"btnStatusLedOff=\"Status-LED UIT\""
btnDelLog="\"btnDelLog=\"Dit logbestand verwijderen\""
btnRefresh="\"btnRefresh=\"Pagina vernieuwen\""
btnShowDetailLog="\"btnShowDetailLog=\"Toon gedetailleerd debug-logbestand\""
btnShowSimpleLog="\"btnShowSimpleLog=\"Toon eenvoudig logboek\""
hrefLog="\"hrefLog=\"Log van acties\""
btnShowLicence="\"btnShowLicence=\"Licence\""
btnShowSettings="\"btnShowSettings=\"Toon instellingen\""
btnDownload="\"btnDownload=\"Download ...\""
execLogNA="'execLogNA=\"Logbestand niet gevonden of leeg. Was er al een opslagapparaat met een scriptbestand in de hoofdmap aangesloten na de start van dit pakket?\""
HASH_DELETION="'HASH_DELETION=\"<b>De vorige geregistreerde hashes zijn nu allemaal verwijderd.</b> \""
copyPriviledge="'copyPriviledge=\"U kunt het vereiste commando uitvoeren <input type='\''text'\'' size='\''80'\'' value='\''sudo cp /var/packages/$SYNOPKG_PKGNAME/conf/privilege.root /var/packages/$SYNOPKG_PKGNAME/conf/privilege'\''> via SSH (of geplande taak)<strong>nu!</strong> Na '\''OK'\'' kunt u vervolgens het pakket starten met '\''Run'\''.\"'"
scriptNA="'scriptNA=\"Fout: Het Skript '\'$f'\' kon niet worden gevonden!\""
scriptNAcase="\"scriptNAcase=\"Verdacht: Bestand met verschillende hoofdletters/kleine letters gevonden!\""
setupCorrection="setupCorrection=\"Mogelijk moet u de installatie opnieuw uitvoeren om de instelling te corrigeren!\""
scriptNexec="'scriptNexec=\"Fout: Het Skript '$f' is niet uitvoerbaar!\""
wrongLineBreakWin="'wrongLineBreakWin=\"Fout: Het Skript '$f', dat uitgevoerd zou moeten worden, gebruikt de verkeerde regeleinde CR/LF (Windows). Gebruik alstublieft een siutable Editor (Linux oder Windows Notepad  , PSPad, ...) om het te veranderen in LF (UNIX)!\""
wrongCodePage="'wrongCodePage=\"Fout: Het Skript '$f', dat uitgevoerd zou moeten worden, gebruikt de verkeerde codering (Windows ISO-8859). Gebruik alstublieft een siutable Editor (Linux oder Windows Notepad  , PSPad, ...) om het te veranderen in UTF-8!\""
wrongLineBreakMac="'wrongLineBreakMac=\"Fout: Het Skript '\'$f'\', dat uitgevoerd zou moeten worden, gebruikt de verkeerde line break CR (MAC). Gebruik een siutable Editor om het te veranderen in LF (UNIX)!\""
notifyUserError="'notifyUserError=\"De gebruikersaccount '\fyUsers'\' voor desktopberichten bestaat niet! Daarom de verkeerde invoer vervangen door groep '\''@users'\''. Voer de installatie opnieuw uit om een andere waarde in te voeren!\""
notifyGroupError="'notifyGroupError=\"De gebruikersgroep '\fyUsers'\' voor desktopberichten bestaat niet! Daarom is de verkeerde invoer vervangen door '@users'\'. Voer de installatie opnieuw uit om een andere waarde in te voeren!\""
update_available="'update_available=\"<span style='^'color:red'^'>Een ${app_name} update is beschikbaar op GitHub.</span> Werk uw versie ${local_version} bij naar versie\""
txtAlertOnlyAdmin="\"txtAlertOnlyAdmin=\"Toegang is alleen toegestaan voor leden od de groep Administrators\""
txtLanguageSource="'txtLanguageSource=\"De taal van deze pagina is geselecteerd volgens de regionale instellingen van uw webbrowser.\""
preinstDsmVersError="'preinstDsmVersError=\"Deze pakketversie kan alleen worden gebruikt in DSM ${osMin} en hoger! Eerdere pakketversies kunnen mogelijk zijn op uw DSM-versie, zie <a target='\blank'\' rel='\noopener noreferrer'\' href='\l'https://github.com/reidemei/synology-autorun#install'\l'>https://github.com/reidemei/synology-autorun#install</a>\""

