#!/bin/bash
# This file was generated via DeepL machine translation from en
# Filename: <lng>/lang.txt - coded in utf-8
# Language variables for cgi pages in the user language
# --------------------------------------------------------------
displaynameINFO="Autorun"
descriptionINFO="Führt ein Skript auf einem externen Laufwerk (USB / eSATA) aus, wenn es an die Disk Station angeschlossen ist."
LoginRequired="Anmeldung erforderlich"
PleaseLogin="Bitte loggen Sie sich zuerst als Administrator ein, bevor Sie diese Webseite benutzen"
settingsTitle="Aktuelle $app_name Einstellungen:"
logTitleExec="Protokoll der Aktionen (Geräteanbindung, Skriptausführung und Geräteauswurf)"
logTitleDetail="Protokoll der Aktivitäten. Die aktuelle Protokollstufe ist '$LOGLEVEL'."
settingFingerprint="Das mit Root-Zugriff ausgeführte Skript stellt ein Sicherheitsrisiko dar, insbesondere wenn es mit Speicherort auf dem externen Speicher konfiguriert ist. Die Ausführung kann auf Skripte beschränkt werden, die einer zuvor registrierten SHA256-Prüfsumme entsprechen.<br>0: Keine Einschränkung. Zuvor registrierte Prüfsummen werden beibehalten.<br>1: Wenn es zuvor registrierte Prüfsummen gibt, werden sie gelöscht. Das erste Skript mit seiner Prüfsumme wird als erlaubte Prüfsumme registriert.<br>2: Alle Skripte sind erlaubt und ihre Prüfsummen werden registriert, wenn sie nicht schon vorher registriert wurden.<br>3: Nur Skripte mit vorher registrierten Prüfsummen sind erlaubt."
settingSecurityWarning="<span style=\"color:red\"><b>Achtung:</b></span> Die Kombination der Skriptvariante a) (Skript auf externem USB/eSATA-Gerät) mit der Fingerprint-Einstellung 0 oder 2 kann ein kritisches Sicherheitsrisiko darstellen: Skripte mit beliebigem Inhalt auf dem externen Speichergerät werden beim Einstecken ausgeführt und haben Zugriff auf alles! Das Einstecken des Geräts kann ausreichen, um die Daten auf Ihrem Synology NAS zu zerstören oder zu stehlen!"
settingScript="Variante a: Das Skript befindet sich im Stammverzeichnis des externen Speichermediums und ist als ausführbar für den Benutzer 'root' eingestellt. Angegeben wird der reine Skriptname ohne Pfad oder Schrägstrich.<br>Variante b: Das Skript wird mit seinem vollständigen Pfad angegeben und befindet sich auf dem NAS.<br>Es erhält den Einhängepunkt des Geräts (z.B. /volumeUSB1/usbshare/) als ersten Parameter ($1) und die Gerätepartition (z.B. usb1p1) als zweiten ($2). Es muss für 'root' ausführbar sein. Für 'root' wird in DSM 7 die Shell 'ash' verwendet. Aber /bin/ash kann ein Link zu 'bash' sein (zumindest auf einer DS220 ). Das Skript wird mit einer leeren Umgebung gestartet! Es ist also kein PATH gesetzt. Sie müssen für jeden Befehl den vollen Pfad verwenden (z.B. /bin/echo "...", /bin/printf ...). Ihr Skript kann mit dem Exit-Code 2 abbrechen, wenn ein Befehl aufgrund eines fehlenden Pfades nicht gefunden wird. In den ersten Zeilen Ihres Skripts können Sie ein 'unset PATH' verwenden, um bei Debugging-Läufen des Skripts die gleichen Bedingungen zu haben. Oder Sie fügen eine Zeile wie 'PATH=/sbin:/bin:/usr/sbin:/usr/bin:/usr/syno/sbin:/usr/syno/bin:/usr/local/sbin:/usr/local/bin' an den Anfang Ihres Skripts."
settingScriptAfter="Wenn das Skript mit dem Exit-Code 100 beendet wird, wirft Autorun das Speichermedium aus und ruft anschließend dieses zweite Skript auf. Dies ist optional. Typische Anwendung ist das Ausschalten einer Festplatte mit externer Stromversorgung über einen Smart Power Adapter."
settingTries="Die Zeit (in Sekunden), wie lange Autorun nach einem gemounteten Laufwerk suchen soll. Erhöhen Sie diesen Wert, wenn Sie die Fehlermeldung 'Einhängepunkt nicht gefunden' erhalten."
settingWait="Eine zusätzliche Wartezeit (in Sekunden) nach dem Einhängen wird vor dem Start des Skripts erkannt. In einigen Fällen ist eine Verzögerung von einigen Sekunden für einen ordnungsgemäßen Laufwerkszugriff erforderlich."
settingBeep="Bei der Einstellung \"true\" ertönt ein kurzer Piepton, wenn ein Skript gefunden wird. Im Falle eines Fehlers ertönt ein dreifach langer Signalton."
settingLedStatus="Die Status-LED kann verwendet werden, um den Status des Skripts anzuzeigen.<br>0: Die Status-LED wird von diesem Paket verwendet.<br>1: 1: Grün, während das Skript läuft, grünes Blinken während des Auswerfens, AUS, wenn es mit 0 oder 100 beendet wurde, orangefarbenes Blinken bei anderen Ergebnissen oder fehlgeschlagenem Auswerfen<br/>2: Grünes Blinken, während das Skript läuft oder ausgeworfen wird, grün, wenn es mit 0 oder 100 beendet wurde, orangefarbenes Blinken bei anderen Ergebnissen oder fehlgeschlagenem Auswerfen<br/>3: Grün, während das Skript läuft und während des Auswerfens, AUS, wenn es beendet wurde, orangefarbenes Blinken bei fehlgeschlagenem Auswerfen."
settingLedCopy="Die Status-LED kann auch zur Anzeige des Skriptstatus verwendet werden.<br>0: Die Kopier-LED wird von diesem Paket verwendet.<br>1: Leuchtet während des Laufs oder des Auswurfs, danach AUS<br/>2: Blinkt während des Laufs oder des Auswurfs, danach AUS<br/>3: Leuchtet während des Laufs oder des Auswurfs, danach AUS (0/100) oder blinkend (andere Codes)<br/>4: Blinkt während des Laufs oder des Auswurfs, danach AUS oder blinkend (andere Codes oder Auswurffehler)<br/>5: Blinkt während des Laufs oder des Auswurfs, danach AUS (0/100) oder EIN (andere Codes oder Auswurffehler)"
settingNoDsmMessageReturnCodes="Normalerweise wird nach Beendigung Ihres Skripts eine DSM-Desktop-Meldung erzeugt. Die Meldung enthält den Rückgabecode Ihres Skripts und den verbleibenden freien Speicherplatz auf dem Speichergerät. Wenn Ihr Skript mit einem der hier angegebenen Codes beendet wird, wird keine solche Meldung erzeugt. Ein Eintrag in der Logdatei des Pakets wird dennoch erzeugt."
ledResetHint="Je nach den LED-Einstellungen können die LEDs auf dem Gerät einen Fehlerzustand anzeigen, nachdem das Skript beendet wurde. Mit dem Befehl <span style=\"font-family:'Courier New'\" translate='no'>echo 8 4 B> /dev/ttyS1</span>, ausgeführt als 'root', kann der normale Zustand wiederhergestellt werden. Sie können in der Systemsteuerung eine geplante Aufgabe für ein benutzerdefiniertes Skript für den Root-Benutzer mit dem Ausführungsbefehl <span style=\"font-family:'Courier New'\" translate='no'>echo 8 4 B> /dev/ttyS1</span> erstellen (8: Status-LED grün, 4: Power-LED an, B: Copy-LED aus). Und führen Sie das aus, wenn es notwendig ist, die LEDs zurückzusetzen."
settingEjectTimeout="Wenn im Falle des Exit-Codes 100 das externe Laufwerk nicht ausgeworfen werden kann (weil es belegt ist), gibt dies die Zeitspanne in Sekunden an, bevor die Auswurfversuche mit Fehler beendet werden."
settingLogMaxLines="Um zu verhindern, dass zu viel Platz durch die Logdateien belegt wird, wird die ältere Hälfte der Dateien gelöscht, wenn die Zeilenzahl die angegebene Zahl erreicht hat."
settingLogVerbose="Es stehen mehrere Detailstufen für das Schreiben von Meldungen in die Debug-Logdatei zur Verfügung: 1 ... 8. Je höher der Wert, desto mehr Details."
settingNotifyUsers="Das Paket erzeugt Desktop-Benachrichtigungen, die einem konfigurierbaren Benutzer oder einer Benutzergruppe angezeigt werden. Ein Name, der mit '@' beginnt, ist ein Gruppenname."
settingHeadlineFingerprints="Tatsächlich registrierte SHA256-Prüfsummen (Fingerabdrücke) von Skriptdateien:"
runInstallationAgain="Sie können die Installation erneut ausführen, um die Einstellungen zu ändern oder die Prüfsummen zu löschen!"
ledCtrlHint="Wenn die LEDs immer noch einen Fehler anzeigen, können Sie sie hier zurücksetzen:"
btnCopyLedOff="Kopier-LED aus"
btnStatusLedGreen="Status-LED grün"
btnStatusLedOff="Status-LED aus"
btnDelLog="Diese Protokolldatei löschen"
btnRefresh="Seite aktualisieren"
btnShowDetailLog="Detaillierte Debug-Protokolldatei anzeigen"
btnShowSimpleLog="Einfaches Protokoll anzeigen"
hrefLog="Protokoll der Aktionen"
btnShowLicence="Lizenz"
btnShowSettings="Einstellungen anzeigen"
btnDownload="Herunterladen ..."
execLogNA="Logdatei nicht gefunden oder leer. War nach dem Start dieses Pakets bereits ein Speichermedium mit einer Skriptdatei im Stammverzeichnis angeschlossen?"
HASH_DELETION="<b>Vorherige registrierte Hashes werden jetzt alle gelöscht.</b>"
copyPriviledge="Sie können den erforderlichen Befehl <input type='text' size='80' value='sudo cp /var/packages/$SYNOPKG_PKGNAME/conf/privilege.root /var/packages/$SYNOPKG_PKGNAME/conf/privilege'> per SSH (oder geplanter Aufgabe)<strong> jetzt ausführen!</strong> Nach 'OK' können Sie dann das Paket mit 'Run' starten."
scriptNA="Fehler: Das Skript '$f' konnte nicht gefunden werden!"
scriptNAcase="Verdächtig: Datei mit unterschiedlicher Groß-/Kleinschreibung gefunden!"
setupCorrection="Möglicherweise müssen Sie die Installation erneut ausführen, um die Einstellung zu korrigieren!"
scriptNexec="Fehler: Das Skript '$f' ist nicht ausführbar!"
wrongLineBreakWin="Fehler: Das Skript '$f', das ausgeführt werden soll, verwendet den falschen Zeilenumbruch CR/LF (Windows). Bitte verwenden Sie einen geeigneten Editor (Linux oder Windows Notepad  , PSPad, ...), um es in LF (UNIX) zu ändern!"
wrongCodePage="Fehler: Das Skript '$f', das ausgeführt werden soll, verwendet die falsche Kodierung (Windows ISO-8859). Bitte verwenden Sie einen geeigneten Editor (Linux oder Windows Notepad  , PSPad, ...), um es in UTF-8 zu ändern!"
wrongLineBreakMac="Fehler: Das Skript '$f', das ausgeführt werden soll, verwendet den falschen Zeilenumbruch CR (MAC). Bitte verwenden Sie einen geeigneten Editor, um es in LF (UNIX) zu ändern!"
notifyUserError="Das Benutzerkonto '$notyfyUsers' für Desktop-Nachrichten existiert nicht! Daher wird der falsche Eintrag durch die Gruppe '@users' ersetzt. Führen Sie die Installation erneut aus, um einen anderen Wert einzugeben!"
notifyGroupError="Die Benutzergruppe '$notyfyUsers' für Desktop-Nachrichten existiert nicht! Daher wird der falsche Eintrag durch '@users' ersetzt. Führen Sie die Installation erneut aus, um einen anderen Wert einzugeben!"
update_available="<span style='color:red'>Ein ${app_name} Update ist auf GitHub verfügbar.</span> Bitte aktualisieren Sie Ihre Version ${local_version} auf Version"
txtAlertOnlyAdmin="Der Zugriff ist nur für Mitglieder der Gruppe \"Administratoren\" erlaubt."
txtLanguageSource="Die Sprache dieser Seite wurde entsprechend den regionalen Einstellungen Ihres Webbrowsers ausgewählt."
preinstDsmVersError="Diese Paketversion kann nur in DSM ${osMin} und höher verwendet werden! Frühere Paketversionen können in Ihrer DSM-Version möglich sein, siehe <a target='_blank' rel='noopener noreferrer' href='https://github.com/reidemei/synology-autorun#install'>https://github.com/reidemei/synology-autorun#install</a>"

