#!/bin/bash
# This file was generated via DeepL machine translation from en
# Filename: <lng>/lang.txt - coded in utf-8
# Language variables for cgi pages in the user language
# --------------------------------------------------------------
displaynameINFO="Autorun"
descriptionINFO="Exécute un script sur/pour un lecteur externe (USB / eSATA) une fois qu'il est connecté à la Disk Station."
LoginRequired="Connexion requise"
PleaseLogin="Veuillez vous connecter en tant qu'administrateur avant d'utiliser cette page web."
settingsTitle="Paramètres réels de $app_name :"
logTitleExec="Journal des actions (fixation du dispositif, exécution du script et éjection du dispositif)"
logTitleDetail="Journal de débogage des activités. Le niveau actuel du journal est '$LOGLEVEL'."
settingFingerprint="Le script exécuté avec un accès root est un risque de sécurité, surtout s'il est configuré avec un emplacement sur le stockage externe. L'exécution peut être limitée aux scripts correspondant aux sommes de contrôle SHA256 précédemment enregistrées.<br>0 : Aucune restriction. Les sommes de contrôle précédemment enregistrées sont préservées.<br>1 : S'il y a des sommes de contrôle précédemment enregistrées, elles sont supprimées. Le 1er script avec sa somme de contrôle est enregistré comme somme de contrôle autorisée.<br>2 : Tous les scripts sont autorisés et leurs sommes de contrôle sont enregistrées, si elles ne l'étaient pas déjà auparavant.<br>3 : Seuls les scripts avec des sommes de contrôle précédemment enregistrées sont autorisés."
settingSecurityWarning="<span style=\"color:red\"><b>Attention:</b></span> Combiner la variante de script a) (script sur le périphérique USB/eSATA externe) avec le paramètre d'empreinte digitale 0 ou 2 peut constituer un risque de sécurité critique : Les scripts avec un contenu arbitraire sur le périphérique de stockage externe sont exécutés lorsqu'il est branché et ont accès à tout ! Le brancher peut être suffisant pour détruire ou voler les données de votre Synology NAS !"
settingScript="Variante a : Le script est situé dans le répertoire racine du périphérique de stockage externe et défini comme exécutable pour l'utilisateur 'root'. Le nom de script pur est donné sans chemin d'accès ni barre oblique.<br>Variante b : Le script est donné avec son chemin d'accès complet et est situé sur le NAS.<br>Il obtient le point de montage du périphérique (par exemple /volumeUSB1/usbshare/) comme premier paramètre (\$1) et la partition du périphérique (par exemple usb1p1) comme second (\$2). Il doit être exécutable pour 'root'. Dans DSM 7, le shell 'ash' est utilisé par 'root'. Mais /bin/ash peut être un lien vers 'bash' (au moins sur une DS220 ). Le script est lancé avec un environnement vide ! Donc aucun PATH n'est défini. Vous devez utiliser le chemin complet pour chaque commande (par exemple /bin/echo \"...\", /bin/printf ...). Votre script peut s'arrêter avec le code de sortie 2 si une commande n'est pas trouvée à cause d'un chemin manquant. Dans les premières lignes de votre script, vous pouvez utiliser un 'unset PATH' pour avoir les mêmes conditions dans les exécutions de débogage du script. Ou vous ajoutez une ligne comme 'PATH=/sbin:/bin:/usr/sbin:/usr/bin:/usr/syno/sbin:/usr/syno/bin:/usr/local/sbin:/usr/local/bin' au début de votre script."
settingScriptAfter="Si le script se termine avec certains codes de sortie définis, autorun éjectera le périphérique de stockage et appellera ensuite ce deuxième script. Ceci est optionnel. L'utilisation typique est d'éteindre un disque dur avec une alimentation externe via un adaptateur d'alimentation intelligent."
settingTries="Le temps (en secondes) pendant lequel autorun doit rechercher un lecteur monté. Augmentez cette valeur lorsque vous obtenez l'erreur \"unable to find mount point\"."
settingWait="Un temps d'attente supplémentaire (en secondes) après le montage est détecté avant de lancer le script. Dans certains cas, un délai de quelques secondes est nécessaire pour un accès correct au lecteur."
settingBeep="S'il est réglé sur 'true', un bip court retentit lorsqu'un script est trouvé. Et un bip triplement long en cas d'erreur."
settingLedStatus="La LED d'état peut être utilisée pour indiquer l'état du script.<br>0 : La LED d'état n'est pas utilisée par ce paquet.<br>1 : Vert pendant l'exécution, vert clignotant pendant l'éjection, éteint si le script a terminé avec 0 ou l'un des codes définis pour l'éjection, orange clignotant pour les autres résultats ou l'échec de l'éjection<br/>2 : Vert clignotant pendant l'exécution ou l'éjection du script, vert si le script a terminé avec 0 ou l'un des codes définis pour l'éjection, orange clignotant pour les autres résultats ou l'échec de l'éjection<br/>3 : Vert pendant l'exécution du script et pendant l'éjection, éteint si le script a terminé, orange clignotant en cas d'échec de l'éjection."
settingLedCopy="Le voyant d'état peut également être utilisé pour indiquer l'état du script.<br>0 : Le voyant de copie n'est pas utilisé par ce paquet.<br>1 : allumée pendant l'exécution ou l'éjection, éteinte après<br/>2 : clignotante pendant l'exécution ou l'éjection, éteinte après<br/>3 : allumée pendant l'exécution ou l'éjection, éteinte après (0 ou l'un des codes avec éjection) ou clignotante (autres codes)<br/>4 : Clignotant pendant la course ou l'éjection, ensuite OFF ou clignotant (autres codes ou échec de l'éjection)<br/>5 : Clignotant pendant la course ou l'éjection, ensuite OFF (0 ou l'un des codes avec éjection) ou ON (autres codes ou échec de l'éjection)."
settingNoDsmMessageReturnCodes="Normalement, un message de bureau DSM est généré après la fin de votre script. Ce message contient le code de retour de votre script et l'espace libre restant sur le périphérique de stockage. Si votre script se termine avec l'un des codes donnés ici, alors aucun message de ce type n'est généré. Une entrée dans le fichier journal du paquet est tout de même générée."
settingEjectTimeout="Si, dans le cas d'un code de sortie configuré pour l'éjection du périphérique, le lecteur externe ne peut pas être éjecté (parce qu'il est occupé), cela donne le délai en secondes avant de mettre fin aux tentatives d'éjection avec une erreur."
settingLogMaxLines="Pour éviter que trop d'espace soit occupé par les fichiers journaux, la moitié la plus ancienne des fichiers est supprimée si le nombre de lignes a atteint le nombre donné."
settingLogVerbose="Plusieurs niveaux de détail sont disponibles pour l'écriture des messages dans le fichier journal de débogage : 1 ... 8. Plus la valeur est élevée, plus les détails sont nombreux."
settingNotifyUsers="Le paquet génère des notifications de bureau, qui sont affichées à un utilisateur ou à un groupe d'utilisateurs configurable. Un nom commençant par '@' est un nom de groupe, de sorte qu'il est affiché à tous ces membres.<br>Conseils:<br>Les administrateurs sont également membres du groupe <code>@users</code>.<br>Avec la commande <code>/usr/syno/bin/synodsmnotify -c \"SYNO.SDS._ThirdParty.App.autorun\" \"@users\" \"autorun:app1:title02\" \N- \"autorun:app1:msg0\N\" \N- \"\NVotre texte de message\N\"</code> vous pouvez générer des messages supplémentaires à partir de vos scripts."
settingHeadlineFingerprints="Sommes de contrôle SHA256 (empreintes digitales) des fichiers de script actuellement enregistrées :"
settingCapture="La sortie vers stdout de votre script (ou de vos scripts) peut être insérée dans le journal de l'Autorun:<br>0 : La sortie n'est pas capturée.<br>1 : La sortie est insérée dans le journal de l'action principale de l'Autorun.<br>2 : La sortie est insérée dans le journal de débogage."
settingsEjectReturnCodes="Votre script peut sortir avec un code de retour 0 .... 255. Vous pouvez spécifier des codes de retour ou des plages de codes de retour pour lesquels le périphérique de stockage externe est éjecté après la fin de votre script."
settingFailureCodes="Liste des codes de sortie du script, qui sont considérés comme un échec et éventuellement signalés par les DEL ou le signal sonore."
settingCGIDEBUG="&lt;empty&gt; : L'exécution de index.cgi et settings.cgi ne génère pas d'entrées de journal de débogage.<br>checked : L'exécution de index.cgi et settings.cgi génère des entrées de journal de débogage. Cela peut prêter à confusion lors du débogage d'autres problèmes."
runInstallationAgain="Vous pouvez relancer l'installation pour modifier les paramètres ou supprimer les sommes de contrôle !"
ledCtrlHint="Si les LEDs indiquent toujours une erreur, vous pouvez la réinitialiser ici :"
btnLedOff="OFF"
btnLedOn="ON"
btnStatusLedGreen="Vert"
labelStatusLed="LED d'état"
labelCopyLed="LED de copie"
btnLedFlash="clignotant"
btnLedGreenFlash="Vert clignotant"
btnLedOrangeFlash="Orange clignotant"
btnLedOrange="orange"
btnDelLog="Supprimer ce fichier journal"
btnRefresh="Rafraîchir la page"
btnShowDetailLog="Afficher le fichier journal de débogage détaillé"
btnShowSimpleLog="Afficher le fichier journal de l'action"
hrefLog="Journal des actions"
btnShowLicence="Licence"
btnShowSettings="Afficher les paramètres"
btnDownload="Télécharger ..."
execLogNA="Fichier journal introuvable ou vide. Y a-t-il eu des événements à enregistrer depuis le lancement ?"
HASH_DELETION="<b>Les hachages enregistrés précédemment sont tous supprimés maintenant.</b>"
copyPrivilege="<strong>Important:</strong> Comme les paquets tiers sont restreints par Synology dans DSM 7.x, une étape supplémentaire est nécessaire pour finaliser l'installation et pouvoir exécuter le paquet:<br>Vous devez exécuter la commande suivante : <input type='text' size='80' value='sudo cp /var/packages/\$SYNOPKG_PKGNAME/conf/privilege.root /var/packages/\$SYNOPKG_PKGNAME/conf/privilege'> <strong>Posibillité 1:</strong><br>Ouvrez un shell de commande SSH sur votre NAS (en tant qu'utilisateur admin) et exécutez la commande ci-dessus. Après cela, continuez et <strong>Exécutez</strong> le paquet.<br><strong>Possibilité 2:</strong><br>Indice : Si vous avez déjà fait cela plus tôt, vous pouvez passer à l'étape 2.2.<br>2.1 : Allez maintenant dans le panneau de contrôle au \"Planificateur de tâches\" et créez une tâche planifiée avec un script défini par l'utilisateur. Dans l'onglet général, définissez un nom utile et sélectionnez 'root' comme utilisateur. Dans 'Schedule', vous pouvez sélectionner une date dans le passé et 'Do not repeat'. Dans les 'Paramètres de la tâche', copiez et collez la commande ci-dessus en tant que 'Script défini par l'utilisateur'. Terminez la configuration de la tâche et confirmez l'avertissement.<br>2.2 : Sélectionnez la tâche générée et <strong>exécutez</strong> celle-ci.<br>2.3 : Fermez le panneau de configuration ainsi que cette boîte de dialogue. Allez dans le Centre de Paquets dans les 'Paquets installés', sélectionnez le paquet Autorun et <strong>Exécutez</strong> le !"
scriptNA="Erreur : Le script '$f' est introuvable !"
scriptNAcase="Suspicieux : Fichier avec des majuscules et des minuscules différentes trouvé !"
setupCorrection="Il est possible que vous deviez relancer l'installation pour corriger ce paramètre !"
scriptNexec="Erreur : Le Skript '$f' n'est pas exécutable !"
wrongLineBreakWin="Erreur : Le Skript '$f', qui devrait être exécuté, utilise le mauvais saut de ligne CR/LF (Windows). Veuillez utiliser un éditeur de texte (Linux oder Windows Notepad  , PSPad, ...) pour le changer en LF (UNIX) !"
wrongCodePage="Erreur : Le Skript '$f', qui devrait être exécuté, utilise un codage incorrect (Windows ISO-8859). Veuillez utiliser un éditeur siutable (Linux oder Windows Notepad  , PSPad, ...) pour le changer en UTF-8 !"
wrongLineBreakMac="Erreur : Le Skript '$f', qui devrait être exécuté, utilise le mauvais saut de ligne CR (MAC). Veuillez utiliser un éditeur siutable pour le changer en LF (UNIX) !"
notifyUserError="Le compte utilisateur '$notyfyUsers' pour les messages de bureau n'existe pas ! L'entrée erronée a donc été remplacée par le groupe '@users'. Exécutez à nouveau l'installation pour entrer une autre valeur !"
notifyGroupError="Le groupe d'utilisateurs '$notyfyUsers' pour les messages de bureau n'existe pas ! L'entrée erronée a donc été remplacée par '@users'. Exécutez à nouveau l'installation pour entrer une autre valeur !"
update_available="<span style='color:red'>Une mise à jour de ${nom_de_l'application} est disponible sur GitHub.</span> Veuillez mettre à jour votre version ${local_version} à la version."
txtAlertOnlyAdmin="L'accès est autorisé uniquement pour les membres du groupe des administrateurs."
txtLanguageSource="La langue de cette page a été sélectionnée en fonction des paramètres régionaux de votre navigateur web."
preinstDsmVersError="Cette version du paquet ne peut être utilisée que dans DSM ${osMin} et supérieur ! Des versions antérieures du paquet peuvent être possibles sur votre version DSM, voir <a target='_blank' rel='noopener noreferrer' href='https://github.com/reidemei/synology-autorun#install'>https://github.com/reidemei/synology-autorun#install</a>."
details="Détails"
notAccepted="La licence n'est pas encore acceptée !"
