#!/bin/bash
# This file was generated via DeepL machine translation from en
# Filename: <lng>/lang.txt - coded in utf-8
# Language variables for cgi pages in the user language
# --------------------------------------------------------------
displaynameINFO="Autorun"
descriptionINFO="Udfører et script på et eksternt drev (USB / eSATA), når det er tilsluttet diskstationen."
LoginRequired="Login påkrævet"
PleaseLogin="Log først ind som administrator, før du bruger denne webside"
settingsTitle="Faktisk $app_name Indstillinger:"
logTitleExec="Log over handlinger (vedhæftning af enheden, udførelse af script og udstødning af enheden)"
logTitleDetail="Debug Log over aktiviteterne. Det faktiske logniveau er \"$LOGLEVEL\"."
settingFingerprint="Det med root-adgang udførte script er en sikkerhedsrisiko, især hvis det er konfigureret med placering på det eksterne lager. Udførelsen kan begrænses til scripts, der matcher den tidligere registrerede SHA256-kontrolsum.<br>0: Ingen begrænsning. Tidligere registrerede kontrolsummer bevares.<br>1: Hvis der er tidligere registrerede kontrolsummer, slettes de. Det første script med dets kontrolsum registreres som tilladt kontrolsum.<br>2: Alle scripts er tilladt, og deres kontrolsum registreres, hvis de ikke allerede er registreret før.<br>3: Kun scripts med tidligere registrerede kontrolsumme er tilladt."
settingSecurityWarning="<span style=\"color:red\"><b>Opmærksomhed:</b></span> Kombinationen af scriptvariant a) (script på ekstern USB/eSATA-enhed) med fingeraftryksindstilling 0 eller 2 kan udgøre en kritisk sikkerhedsrisiko: Scripts med vilkårligt indhold på den eksterne lagerenhed udføres, når den er tilsluttet, og har adgang til alt! Det kan være nok til at ødelægge eller stjæle dataene på din Synology NAS, hvis du sætter den i stikket!"
settingScript="Variant a: scriptet er placeret i rodmappen på den eksterne lagerenhed og indstillet som eksekverbart for brugeren \"root\". Det er det rene scriptnavn uden nogen sti eller skråstreg.<br>Variant b: Scriptet er angivet med sin fulde sti og er placeret på NAS'en.<br>Det får enhedens monteringspunkt (f.eks. /volumeUSB1/usbshare/) som den første parameter (\$1) og enhedens partition (f.eks. usb1p1) som den anden (\$2). Den skal være eksekverbar for \"root\". For \"root\" anvendes i DSM 7 shell'en \"ash\". Men /bin/ash kan være et link til 'bash' (i det mindste på en DS220 ). Scriptet det er startet med et tomt miljø! Så der er ikke sat nogen PATH. Du er nødt til for hver kommando at bruge den fulde sti (f.eks. /bin/echo \"...\", /bin/printf ...). Dit script kan stoppe med exitkode 2, hvis en kommando ikke kan findes på grund af manglende sti. I de første linjer i dit script kan du bruge en \"unset PATH\" for at få de samme betingelser i debuggingkørsler af scriptet. Eller du tilføjer en linje som 'PATH=/sbin:/bin:/usr/sbin:/usr/bin:/usr/syno/sbin:/usr/syno/bin:/usr/local/sbin:/usr/local/bin' i starten af dit script."
settingScriptAfter="Hvis scriptet afsluttes med exitkode 100, vil autorun skubbe den pågældende lagerenhed ud og derefter kalde dette andet script. Dette er valgfrit. Typisk brug er at slukke en harddisk med ekstern forsyning via en smart strømforsyningsadapter."
settingTries="Den tid (i sekunder), hvor længe autorun skal søge efter et monteret drev. Øg denne værdi, når du får fejlen \"unable to find mount point\"."
settingWait="En ekstra ventetid (i sekunder) efter montering registreres, før scriptet startes. I nogle tilfælde er der behov for en forsinkelse på nogle få sekunder for at få korrekt adgang til drevet."
settingBeep="Hvis den er indstillet til \"true\", lyder der et kort bip, når et script er fundet. Og et tredobbelt langt bip i tilfælde af en fejl."
settingLedStatus="Status-LED'en kan bruges til at vise scriptets status.<br>0: Status-LED'en bruges af denne pakke.<br>1: 1: Grøn under kørsel, grønt blink under udkast, slukket hvis afsluttet med 0 eller 100, orange blink for andre resultater eller mislykket udkast<br/>2: Grønt blink under kørsel eller udkast, grønt hvis afsluttet med 0 eller 100, orange blink for andre resultater eller mislykket udkast<br/>3: Grønt under kørsel og under udkast, slukket når scriptet er afsluttet, orange blink hvis udkast mislykkedes."
settingLedCopy="Status-LED'en kan også bruges til at vise scriptstatus.<br>0: Kopi-LED'en bruges af denne pakke.<br>1: Tændt under kørsel eller udkast, slukket bagefter<br/>2: Blinker under kørsel eller udkast, slukket bagefter<br/>3: Tændt under kørsel eller udkast, bagefter slukket (0/100) eller blinker (andre koder)<br/>4: Blinker under kørsel eller udkast, bagefter slukket eller blinker (andre koder eller udkastfejl)<br/>5: Blinker under kørsel eller udkast, bagefter slukket (0/100) eller tændt (andre koder eller udkastfejl)."
settingNoDsmMessageReturnCodes="Normalt genereres der en DSM-skrivebordsmeddelelse, når scriptet er færdigt. Meddelelsen indeholder scriptets returkode og den resterende ledige plads på lagerenheden. Hvis dit script afsluttes med en af de koder, der er angivet her, genereres der ikke en sådan meddelelse. Der genereres stadig en post i logfilen for pakken."
ledResetHint="Afhængigt af LED-indstillingerne kan lysdioderne på enheden vise en fejltilstand, når scriptet er afsluttet. Med kommandoen <span style=\"font-family:'Courier New'\" translate='no'>echo 8 4 B> /dev/ttyS1</span>, der udføres som '<span translate='no'>root</span>', kan den normale tilstand genoprettes. Du kan oprette en planlagt opgave i kontrolpanelet til et brugerdefineret script til <span translate='no'>root</span>-brugeren med kommandoen kør <span style=\"font-family:'Courier New'\" translate='no'>echo 8 4 B> /dev/ttyS1</span> (8: Status-LED grøn, 4: Strøm-LED tændt, B: Kopier-LED slukket). Og kør det, hvis det er nødvendigt at nulstille lysdioderne."
settingEjectTimeout="Hvis det eksterne drev i tilfælde af exitkode 100 ikke kan skubbes ud (fordi det er optaget), angiver dette timeout i sekunder, før forsøg på at skubbe det ud med fejl afsluttes."
settingLogMaxLines="For at undgå, at logfilerne optager for meget plads, slettes den ældste halvdel af filerne, hvis linjetallet har nået det angivne antal."
settingLogVerbose="Der er flere detaljeringsniveauer til rådighed til at skrive meddelelser til debug-logfilen: 1 ... 8. Jo højere værdi, desto flere detaljer."
settingNotifyUsers="Pakken genererer skrivebordsmeddelelser, som vises til en konfigurerbar bruger eller brugergruppe. Et navn, der begynder med \"@\", er et gruppenavn."
settingHeadlineFingerprints="I øjeblikket registrerede SHA256-kontrolsummer (fingeraftryk) af scriptfiler:"
runInstallationAgain="Du kan køre installationen igen for at ændre indstillingerne eller slette checksummene!"
ledCtrlHint="Hvis lysdioderne stadig viser en fejl, kan du nulstille den her:"
btnCopyLedOff="Kopiering LED OFF"
btnStatusLedGreen="Status-LED grøn"
btnStatusLedOff="Status-LED OFF"
btnDelLog="Slet denne logfil"
btnRefresh="Opdater side"
btnShowDetailLog="Vis detaljeret debug-logfil"
btnShowSimpleLog="Vis simpel logbog"
hrefLog="Logbog over foranstaltninger"
btnShowLicence="Licens"
btnShowSettings="Vis indstillinger"
btnDownload="Download ..."
execLogNA="Logfil ikke fundet eller tom. Var der allerede en lagerenhed med en scriptfil i rodmappen tilknyttet efter start af denne pakke?"
HASH_DELETION="<b>Tidligere registrerede hashes er alle slettet nu.</b>"
copyPriviledge="Du kan udføre den nødvendige kommando <input type='text' size='80' value='sudo cp /var/packages/$SYNOPKG_PKGNAME/conf/privilege.root /var/packages/$SYNOPKG_PKGNAME/conf/privilege'> via SSH (eller planlagt opgave)<strong>now!</strong> Efter \"OK\" kan du starte pakken med \"Run\"."
scriptNA="Fejl: Skriptet '$f' kunne ikke findes!"
scriptNAcase="Mistænkelig: Fil med forskellige store/små bogstaver fundet!"
setupCorrection="Muligvis skal du køre installationen igen for at rette indstillingen!"
scriptNexec="Fejl: Skriptet '$f' er ikke eksekverbart!"
wrongLineBreakWin="Fejl: Skriptet \"$f\", som skal udføres, bruger det forkerte linjeskift CR/LF (Windows). Brug venligst en siutable Editor (Linux oder Windows Notepad  , PSPad, ...) til at ændre det til LF (UNIX)!"
wrongCodePage="Fejl: Skriptet \"$f\", som skal udføres, bruger den forkerte kodning (Windows ISO-8859). Brug venligst en siutable Editor (Linux oder Windows Notepad  , PSPad, ...) til at ændre den til UTF-8!"
wrongLineBreakMac="Fejl: Skriptet \"$f\", som skal udføres, bruger den forkerte linjeskift CR (MAC). Brug venligst en siutable editor til at ændre det til LF (UNIX)!"
notifyUserError="Brugerkontoen '$notyfyUsers' til desktop-beskeder findes ikke! Derfor er den forkerte post erstattet af gruppen '@users'. Kør installationen igen for at indtaste en anden værdi!"
notifyGroupError="Brugergruppen '$notyfyUsers' for desktop-beskeder findes ikke! Derfor er den forkerte post erstattet af '@users'. Kør installationen igen for at indtaste en anden værdi!"
update_available="<span style='color:red'>En ${app_name}-opdatering er tilgængelig på GitHub.</span> Opdater venligst din version ${local_version} til version"
txtAlertOnlyAdmin="Adgang er kun tilladt for medlemmer af administratorgruppen"
txtLanguageSource="Sproget på denne side blev valgt i overensstemmelse med din webbrowser regionale indstillinger."
preinstDsmVersError="Denne pakkeversion kan kun bruges i DSM ${osMin} og derover! Tidligere pakkeversioner kan være mulige i din DSM-version, se <a target='_blank' rel='noopener noreferrer' href='https://github.com/reidemei/synology-autorun#install'>https://github.com/reidemei/synology-autorun#install</a>"

