#!/bin/bash
# This file was generated via DeepL machine translation from en
# Filename: <lng>/lang.txt - coded in utf-8
# Language variables for cgi pages in the user language
# --------------------------------------------------------------
displaynameINFO="Autorun"
descriptionINFO="Executa um script em/para um disco externo (USB / eSATA) depois de ser ligado à Estação de Disco."
LoginRequired="Login Requerido"
PleaseLogin="Por favor faça primeiro o login como administrador, antes de utilizar esta página web"
settingsTitle="Definições reais de $app_name:"
logTitleExec="Registo de acções (anexação de dispositivos, execução de scripts e ejecção de dispositivos)"
logTitleDetail="Registo de depuração das actividades. O nível real de registo é '$LOGLEVEL'."
settingFingerprint="O script executado com acesso à raiz é um risco de segurança, especialmente se for configurado com localização no armazenamento externo. A execução pode ser restringida a scripts que correspondam à soma de verificação SHA256 previamente registada.<br>0: Sem restrições. Os checksums previamente registados são preservados.<br>1: Se houver checksums previamente registados, estes são eliminados. O 1º script com o seu checksum é registado como checksum permitido.<br>2: Todos os scripts são permitidos e há checksums registados, se não já registados antes.<br>3: Só são permitidos scripts com checksums previamente registados."
settingSecurityWarning="<span style=\"color:red\"><b>Attention:</b></span> Combinando a variante de script a) (script no dispositivo externo USB/eSATA) com a configuração de impressão digital 0 ou 2 pode ser um risco crítico de segurança: Scripts com conteúdo arbitrário no dispositivo de armazenamento externo são executados quando ligados à corrente e têm acesso a tudo! Ligá-lo pode ser suficiente para destruir ou roubar os dados no seu NAS Synology!"
settingScript="Variante a: O script está localizado no directório raiz do dispositivo de armazenamento externo e definido como executável para o utilizador 'raiz'. Dado é o nome puro do script sem qualquer caminho ou barra oblíqua.<br>Variante b: O script é dado com o seu caminho completo e está localizado no NAS.<br> Obtém o ponto de montagem do dispositivo (por exemplo /volumeUSB1/usbshare/) como o primeiro parâmetro (\$1) e a partição do dispositivo (por exemplo usb1p1) como o segundo (\$2). Tem de ser executável para 'raiz'. Para 'root' está no DSM 7 a concha 'ash' utilizada. Mas /bin/ash pode ser uma ligação para 'bash' (pelo menos num DS220 ). O script começou com um ambiente vazio! Por isso, não é definido nenhum PATH. Tem de se utilizar para cada comando o caminho completo (por exemplo /bin/echo \"...\", /bin/printf ...). O seu script pode parar com o código de saída 2 se um comando não for encontrado devido a um caminho em falta. Nas primeiras linhas do seu script, pode usar um 'unset PATH' para ter na execução de depuração do script as mesmas condições. Ou pode adicionar uma linha como 'PATH=/sbin:/bin:/usr/sbin:/usr/bin:/usr/syno/sbin:/usr/syno/bin:/usr/local/sbin:/usr/local/bin' ao início do seu script."
settingScriptAfter="Se o script sair com alguns códigos de saída definidos, então a autorun irá ejectar esse dispositivo de armazenamento e depois chamar este 2º script. Isto é opcional. O uso típico é para desligar um disco rígido com alimentação externa através de um adaptador de alimentação inteligente."
settingTries="O tempo (em segundos) durante o qual a auto-execução deve procurar por uma unidade montada. Aumente este valor quando obtiver o erro \"incapaz de encontrar o ponto de montagem\"."
settingWait="Um tempo de espera adicional (em segordes) após a montagem é detectado antes de iniciar a escrita. Em alguns casos, é necessário um atraso de alguns segundos para um acesso adequado à unidade."
settingBeep="Se for definido para 'verdadeiro', há um curto sinal sonoro quando um guião é encontrado. E um bip longo triplo em caso de erro."
settingLedStatus="O LED de estado pode ser usado para mostrar o estado do script.<br>0: O LED de estado não é usado por este pacote.<br>1: 1: verde durante a execução, verde a piscar durante a ejecção, OFF se terminado com 0 ou um dos códigos definidos para a ejecção, laranja a piscar para outros resultados ou falha na ejecção<br/>2: verde a piscar durante a execução ou ejecção do script, verde se terminado com 0 ou um dos códigos definidos para a ejecção, laranja a piscar para outros resultados ou falha na ejecção<br/>3: verde durante a execução do script e durante a ejecção, OFF quando terminado, laranja a piscar se falha na ejecção."
settingLedCopy="O LED de estado também pode ser usado para mostrar o estado do guião.<br>0: O LED de cópia não é usado por este pacote.<br>1: LIGADO durante a execução ou ejecção, DESLIGADO depois<br/>2: Intermitente durante a execução ou ejecção, DESLIGADO depois<br/>3: LIGADO durante a execução ou ejecção, depois DESLIGADO (0 ou um dos códigos com ejecção) ou intermitente (outros códigos)<br/>4: Intermitente durante a corrida ou ejecção, depois OFF ou intermitente (outros códigos ou ejecção falhando)<br/>5: Intermitente durante a corrida ou ejecção, depois OFF (0 ou um dos códigos com ejecção) ou ON (outros códigos ou ejecçãoFail)"
settingNoDsmMessageReturnCodes="Normalmente há uma mensagem de ambiente de trabalho DSM gerada após o seu script estar terminado. A mensagem contém o código de retorno do seu script e o espaço livre restante no dispositivo de armazenamento. Se o seu script sair com um dos códigos aqui indicados, então tal mensagem não é gerada. Ainda é gerada uma entrada no ficheiro de registo do pacote."
settingEjectTimeout="Se no caso de um código de saída configurado para a ejecção do dispositivo, a unidade externa não pode ser ejectada (por estar ocupada), isto dá o tempo limite em segundos antes de terminar a tentativa de ejecção com erro."
settingLogMaxLines="Para evitar que demasiado espaço seja ocupado pelos ficheiros de registo, a metade mais velha dos ficheiros é apagada se a contagem de linhas tiver atingido o número dado."
settingLogVerbose="Estão disponíveis vários níveis de detalhe para escrever mensagens para o ficheiro de registo de depuração: 1 ... 8. Quanto mais alto for o valor, mais detalhes."
settingNotifyUsers="O pacote gera notificações no ambiente de trabalho, que são mostradas a um utilizador ou grupo de utilizadores configuráveis. Um nome que começa com '@' é um nome de grupo, de modo a ser mostrado a todos esses membros.<br>Dicas:<br>Os administradores são também membros do grupo <código>@utilizadores</código>.<br>Com o comando <código>/usr/syno/bin/synodsmnotify -c \\"SYNO.SDS._ThirdParty.App.autorun\\" \\"@users\\" \\"autorun:app1:title02\\" \"autorun:app1:msg0\\\" \O seu texto de mensagem pode gerar mensagens adicionais a partir do interior dos seus scripts."
settingHeadlineFingerprints="Actualmente registados SHA256 checksums (impressões digitais) de ficheiros de script:"
settingCapture="A saída para stdout do seu script (ou scripts) pode ser inserida no log do Autorun:<br>0: A saída não é capturada.<br>1: A saída é inserida no log de acção principal do Autorun.<br>2: A saída é inserida no log de debug."
settingsEjectReturnCodes="O seu guião pode sair com um código de retorno 0 ... 255. Pode especificar alguns códigos de retorno ou intervalos de códigos de retorno para os quais o dispositivo de armazenamento externo é ejectado após o seu script estar terminado."
settingFailureCodes="Lista de códigos de saída do guião, que são considerados como uma falha e possivelmente sinalizados pelos LEDs ou pelo bip."
settingCGIDEBUG="&lt;vazio&gt;: A execução de index.cgi e settings.cgi não gera entradas de registo de depuração.<br>checked: A execução de index.cgi e settings.cgi gera entradas de registo de depuração. Isto pode ser confuso durante a depuração de outras edições."
runInstallationAgain="Pode voltar a executar a instalação para alterar as definições ou para apagar os checksums!"
ledCtrlHint="Se os LEDs ainda indicarem um erro, pode reinicializá-lo aqui:"
btnLedOff="OFF"
btnLedOn="ON"
btnStatusLedGreen="Verde"
labelStatusLed="LED de estado"
labelCopyLed="Copiar LED"
btnLedFlash="a piscar"
btnLedGreenFlash="Cintilação verde"
btnLedOrangeFlash="Cor-de-laranja a piscar"
btnLedOrange="laranja"
btnDelLog="Apagar este ficheiro de registo"
btnRefresh="Página de Actualização"
btnShowDetailLog="Mostrar ficheiro de registo detalhado de depuração"
btnShowSimpleLog="Mostrar ficheiro de registo de acção"
hrefLog="Registo de acções"
btnShowLicence="Licença"
btnShowSettings="Mostrar definições"
btnDownload="Descarregar ..."
execLogNA="Ficheiro de registo não encontrado ou vazio. Houve algum evento a ser registado desde o lançamento?"
HASH_DELETION="<b>Hashes anteriormente registados são todos apagados agora.</b>"
copyPrivilege="<forte>Importante:</strong> Como os pacotes de terceiros são restringidos pela Synology no DSM 7.x, é necessário um passo adicional para finalizar a instalação e poder executar o pacote:<br>É necessário executar o seguinte comando: <input type='text' size='80' value='sudo cp /var/packages/\$SYNOPKG_PKGNAME/conf/privilege.root /var/packages/\$SYNOPKG_PKGNAME/conf/privilege'> <strong>Posibillity 1:</strong>>br>Abra uma shell de comando SSH ao seu NAS (como utilizador administrador) e execute o comando acima. Depois disso, continue e <forte>Executar>forte> o pacote.<br>forte>Possibilidade 2:</strong>>br>Possibilidade 2:</strong>>br>Possibilidade: Se já o fez antes, pode saltar para o passo 2.2.<br>2.1: Vá agora no painel de controlo para o 'Agendador de Tarefas' e crie uma tarefa agendada com um script definido pelo utilizador. No separador geral definir um nome útil e seleccionar 'root' como o utilizador. Como 'Agendamento' pode seleccionar uma data no passado e a opção 'Não repetir'. Em 'Definições de tarefas' copiar & colar o comando acima como 'Script definido pelo utilizador'. Termine essa configuração de tarefa e confirme o aviso.<br>2.2: Seleccionar a tarefa gerada e <strong>run</strong> it.<br>2.3: Fechar o Painel de Controlo e também este diálogo aqui. Vá no Centro de Pacotes para 'Pacotes instalados', seleccione o pacote Autorun e <strong>Run</strong> it.<br>strong> it!"
scriptNA="Erro: O Skript '$f' não pôde ser encontrado!"
scriptNAcase="Suspeito: Ficheiro com diferentes casos superiores/baixos encontrados!"
setupCorrection="Possivelmente, é necessário executar novamente a instalação para corrigir a configuração!"
scriptNexec="Erro: O Skript '$f' não é executável!"
wrongLineBreakWin="Erro: O Skript '$f', que deve ser executado, utiliza a quebra de linha errada CR/LF (Windows). Por favor, use um Editor siutable (Linux ou Windows Notepad  , PSPad, ...) para o alterar para LF (UNIX)!"
wrongCodePage="Erro: O Skript '$f', que deve ser executado, utiliza a codificação errada (Windows ISO-8859). Por favor, use um editor siutable (Linux ou Windows Notepad  , PSPad, ...) para o alterar para UTF-8!"
wrongLineBreakMac="Erro: O Skript '$f', que deve ser executado, utiliza a quebra de linha errada CR (MAC). Por favor, use um Editor siutable para o alterar para LF (UNIX)!"
notifyUserError="A conta de utilizador '$notyfyUsers' para mensagens desktop não existe! Por conseguinte, a entrada errada foi substituída pelo grupo '@utilizadores'. Execute novamente a Instalação para introduzir outro valor!"
notifyGroupError="O grupo de utilizadores '$notyfyUsers' para mensagens desktop não existe! Por conseguinte, a entrada errada foi substituída por '@utilizadores'. Execute novamente a Instalação para introduzir outro valor!"
update_available="<span style='color:red'>A actualização ${app_name} está disponível em GitHub.</span> Por favor actualize a sua versão ${local_version} para a versão"
txtAlertOnlyAdmin="O acesso só é permitido aos membros do grupo de administradores"
txtLanguageSource="O idioma desta página foi seleccionado de acordo com as definições regionais do seu navegador da Internet."
preinstDsmVersError="Esta versão do pacote só pode ser usada em DSM ${osMin} e acima! Versões anteriores do pacote podem ser possíveis na sua versão DSM, ver <a target='_blank' rel='noopener noreferrer' href='https://github.com/reidemei/synology-autorun#install'>https://github.com/reidemei/synology-autorun#install</a>"
details="Detalhes"
notAccepted="A licença ainda não é aceite!"
