#!/bin/bash
# This file was generated via DeepL machine translation from en
# Filename: <lng>/lang.txt - coded in utf-8
# Language variables for cgi pages in the user language
# --------------------------------------------------------------
displaynameINFO="'displaynameINFO=\"Autorun\"'"
descriptionINFO="'descriptionINFO=\"Disk istasyonuna bağlandığında harici sürücü (USB / eSATA) üzerinde bir komut dosyası çalıştırır.\"'"
LoginRequired="'LoginRequired=\"Giriş Gerekli\"'"
PleaseLogin="'PleaseLogin=\"Lütfen bu web sayfasını kullanmadan önce yönetici olarak giriş yapın\"'"
settingsTitle="'settingsTitle=\"Actual $app_name Settings:\"'"
logTitleExec="'logTitleExec=\"Eylemlerin günlüğü (cihaz ekleme, komut dosyası yürütme ve cihaz çıkarma)\"'"
logTitleDetail="'logTitleDetail=\"Faaliyetlerin Hata Ayıklama Günlüğü. Gerçek günlük seviyesi '\''$LOGLEVEL'\''\""
settingFingerprint="'settingFingerprint=\"Kök erişimiyle çalıştırılan komut dosyası, özellikle harici depolama alanındaki konumla yapılandırılmışsa bir güvenlik riskidir. Yürütme, önceden kaydedilmiş SHA256 sağlama toplamıyla eşleşen komut dosyalarıyla kısıtlanabilir.<br>0: Kısıtlama yok. Önceden kaydedilmiş sağlama toplamları korunur.<br>1: Önceden kaydedilmiş sağlama toplamları varsa, bunlar silinir. Sağlama toplamına sahip 1. komut dosyası izin verilen sağlama toplamı olarak kaydedilir.<br>2: Tüm komut dosyalarına izin verilir ve sağlama toplamları kaydedilir.<br>3: Yalnızca önceden kaydedilmiş sağlama toplamlarına sahip komut dosyalarına izin verilir.\"'"
settingScript="'settingScript=\"Variant a: Komut dosyası harici depolama cihazının kök dizininde bulunur ve '\''root'\'' kullanıcısı için çalıştırılabilir olarak ayarlanır. Verilen, herhangi bir yol veya eğik çizgi olmadan saf komut dosyası adıdır.<br>Varyant b: Komut dosyası '\' tam yolu ile verilir ve NAS üzerinde bulunur.<br>Aygıtın bağlama noktasını (örn. /volumeUSB1/usbshare/) ilk parametre ($1) ve aygıt bölümünü (örn. usb1p1) ikinci parametre ($2) olarak alır. '\''root'\'' için çalıştırılabilir olması gerekir. Boş bir ortam ile başlatılır. Yani hiçbir PATH ayarlanmamıştır. Her komut için tam yolu (örneğin /bin/echo \"...\") kullanmanız veya PATH'i ayarlamanız gerekir.\"'"
settingScriptAfter="'settingScriptAfter=\"Komut dosyası 100 çıkış koduyla çıkarsa, autorun bu depolama aygıtını çıkaracak ve ardından bu 2. komut dosyasını çağıracaktır. Bu isteğe bağlıdır. Tipik kullanım, akıllı bir güç adaptörü aracılığıyla harici beslemeli bir HDD'yi kapatmaktır.\"'"
settingTries="'settingTries=\"Otomatik çalıştırmanın takılı bir sürücüyü ne kadar süreyle araması gerektiği (saniye cinsinden). \"Bağlama noktası bulunamıyor\" hatasını aldığınızda bu değeri artırın.\"'"
settingWait="'settingWait=\"Kod başlatılmadan önce montaj algılandıktan sonra ek bir bekleme süresi (saniye cinsinden). Bazı durumlarda düzgün sürücü erişimi için birkaç saniye gecikme gerekir.\"'"
settingBeep="'settingBeep=\"Eğer '\''true'\'' olarak ayarlanırsa, bir komut dosyası bulunduğunda kısa bir bip sesi duyulur. Ve bir hata durumunda üç kat uzun bir bip sesi.\"'"
settingLedStatus="'settingLedStatus=\"Durum LED'i kod durumunu göstermek için kullanılabilir.<br>0: Durum LED'i bu paket tarafından kullanılır.<br>1: 1: Çalışırken yeşil, çıkarma sırasında yeşil yanıp söner, 0 veya 100 ile bittiğinde KAPALI, diğer sonuçlar veya başarısız çıkarma için turuncu yanıp söner<br/>2: Kod çalışırken veya çıkarılırken yeşil yanıp söner, 0 veya 100 ile bittiğinde yeşil, diğer sonuçlar veya başarısız çıkarma için turuncu yanıp söner<br/>3: Kod çalışırken ve çıkarma sırasında yeşil, bittiğinde KAPALI, çıkarma başarısız olduğunda turuncu yanıp söner.\"'"
settingLedCopy="'settingLedCopy=\"Durum LED'i kod durumunu göstermek için de kullanılabilir.<br>0: Kopyalama LED'i bu paket tarafından kullanılır.<br>1: Çalışırken veya çıkarılırken AÇIK, sonrasında KAPALI<br/>2: Çalışırken veya çıkarılırken yanıp söner, sonrasında KAPALI<br/>3: Çalışırken veya çıkarılırken AÇIK, sonrasında KAPALI (0/100) veya yanıp söner (diğer kodlar)<br/>4: Çalışırken veya çıkarılırken yanıp söner, sonrasında KAPALI veya yanıp söner (diğer kodlar veya çıkarma başarısız)<br/>5: Çalışırken veya çıkarılırken yanıp söner, sonrasında KAPALI (0/100) veya AÇIK (diğer kodlar veya çıkarma başarısız)\""
settingNoDsmMessageReturnCodes="'settingNoDsmMessageReturnCodes=\"Normalde, komut dosyanız tamamlandıktan sonra bir DSM masaüstü mesajı oluşturulur. Mesaj, kodunuzun dönüş kodunu ve depolama aygıtında kalan boş alanı içerir. Kodunuz burada verilen kodlardan biriyle çıkarsa, böyle bir mesaj oluşturulmaz. Yine de paketin günlük dosyasında bir girdi oluşturulur.\"'"
ledResetHint="'ledResetHint=\"LED ayarlarına bağlı olarak, cihaz üzerindeki LED'ler kod sona erdikten sonra bir hata durumunu gösterebilir. <span style=\"font-family:'\''Courier New'\''\" translate='\''no'\''>echo 8 4 B> /dev/ttyS1</span> komutuyla, '\''root'\'' olarak çalıştırıldığında, normal durum geri yüklenebilir. Kök kullanıcı için özel bir komut dosyası için kontrol panelinde <span style=\"font-family:'\''Courier New'\''\" translate='\''no'\''>echo 8 4 B> /dev/ttyS1</span> (8: Durum LED'i yeşil, 4: Güç LED'i açık, B: Kopyalama LED'i kapalı) çalıştır komutuyla zamanlanmış bir görev oluşturabilirsiniz. Ve LED'leri sıfırlamak gerekirse bunu çalıştırın.\"'"
settingEjectTimeout="'settingEjectTimeout=\"Çıkış kodu 100 olması durumunda harici sürücü çıkarılamazsa (meşgul olduğu için), bu, çıkarma denemelerini hata ile sonlandırmadan önce saniye cinsinden zaman aşımı verir.\"'"
settingLogMaxLines="'settingLogMaxLines=\"Günlük dosyalarının çok fazla yer kaplamasını önlemek için, satır sayısı verilen sayıya ulaştığında dosyaların eski yarısı silinir.\"'"
settingLogVerbose="'settingLogVerbose=\"Hata ayıklama günlük dosyasına mesaj yazmak için çeşitli ayrıntı düzeyleri mevcuttur: 1 ... 8. Değer ne kadar yüksek olursa o kadar fazla ayrıntı olur.\"'"
settingNotifyUsers="'settingNotifyUsers=\"Paket, yapılandırılabilir bir kullanıcıya veya kullanıcı grubuna gösterilen masaüstü bildirimleri oluşturur. '\''@'\'' ile başlayan bir ad bir grup adıdır.\"'"
settingHeadlineFingerprints="'settingHeadlineFingerprints=\"Kod dosyalarının gerçekte kayıtlı SHA256 sağlama toplamları (parmak izleri):\"'"
runInstallationAgain="'runInstallationAgain=\"Ayarları değiştirmek veya sağlama toplamlarını silmek için yüklemeyi tekrar çalıştırabilirsiniz!\"'"
ledCtrlHint="'ledCtrlHint=\"LED'ler hala bir hata olduğunu gösteriyorsa, buradan sıfırlayabilirsiniz:\"'"
btnCopyLedOff="'btnCopyLedOff=\"Copy LED OFF\"'"
btnStatusLedGreen="'btnStatusLedGreen=\"Durum LED'i yeşil\"'"
btnStatusLedOff="'btnStatusLedOff=\"Durum LED'i KAPALI\"'"
btnDelLog="'btnDelLog=\"Bu günlük dosyasını sil\"'"
btnRefresh="'btnRefresh=\"Sayfayı Yenile\"'"
btnShowDetailLog="'btnShowDetailLog=\"Ayrıntılı hata ayıklama günlük dosyasını göster\"'"
btnShowSimpleLog="'btnShowSimpleLog=\"Basit günlüğü göster\"'"
hrefLog="'hrefLog=\"Eylemlerin günlüğü\"'"
btnShowLicence="'btnShowLicence=\"Lisans\"'"
btnShowSettings="'btnShowSettings=\"Ayarları göster\"'"
btnDownload="'btnDownload=\"İndir ...\"'"
execLogNA="'execLogNA=\"Logfile not found or empty. Bu paket başlatıldıktan sonra kök klasörde bir komut dosyası eklenmiş bir depolama aygıtı zaten var mıydı?\"'"
HASH_DELETION="'HASH_DELETION=\"<b>Önceki kayıtlı hash'lerin tümü şimdi siliniyor.</b> \"'"
copyPriviledge="'copyPriviledge=\"Gerekli komutu çalıştırabilirsiniz <input type='\''text'\'' size='\''80'\'' value='\''sudo cp /var/packages/$SYNOPKG_PKGNAME/conf/privilege.root /var/packages/$SYNOPKG_PKGNAME/conf/privilege'\''> SSH üzerinden (veya zamanlanmış görev)<strong>şimdi!</strong> '\''Tamam'\'' dedikten sonra '\''Çalıştır'\'' ile paketi başlatabilirsiniz.\"'"
scriptNA="'scriptNA=\"Hata: Skript '\''$f'\'' bulunamadı!\"'"
scriptNAcase="'scriptNAcase=\"Şüpheli: Farklı büyük/küçük harf içeren dosya bulundu!\"'"
setupCorrection="'setupCorrection=\"Muhtemelen ayarı düzeltmek için kurulumu tekrar çalıştırmanız gerekiyor!\"'"
scriptNexec="'scriptNexec=\"Hata: Skript '\''$f'\'' çalıştırılabilir değil!\"'"
wrongLineBreakWin="'wrongLineBreakWin=\"Hata: Çalıştırılması gereken '\''$f'\'' Skripti yanlış satır sonu CR/LF (Windows) kullanıyor. Lütfen bunu LF (UNIX) olarak değiştirmek için bir siutable Editor (Linux oder Windows Notepad  , PSPad, ...) kullanın!\"'"
wrongCodePage="'wrongCodePage=\"Hata: Çalıştırılması gereken Skript '\''$f'\'' yanlış kodlama (Windows ISO-8859) kullanıyor. Lütfen UTF-8'e değiştirmek için bir siutable Editor (Linux oder Windows Notepad  , PSPad, ...) kullanın!\"'"
wrongLineBreakMac="'wrongLineBreakMac=\"Hata: Çalıştırılması gereken '\''$f'\'' Skripti yanlış satır sonu CR (MAC) kullanıyor. Lütfen bunu LF (UNIX) olarak değiştirmek için bir siutable Editor kullanın!\"'"
notifyUserError="'notifyUserError=\"Masaüstü iletileri için '\''$notyfyUsers'\'' kullanıcı hesabı mevcut değil! Bu nedenle yanlış giriş '\''@users'\'' grubu ile değiştirildi. Başka bir değer girmek için Kurulumu tekrar çalıştırın!\"'"
notifyGroupError="'notifyGroupError=\"Masaüstü iletileri için '\''$notyfyUsers'\'' kullanıcı grubu mevcut değil! Bu nedenle yanlış giriş '\''@users'\'' ile değiştirildi. Başka bir değer girmek için Kurulumu tekrar çalıştırın!\"'"
update_available="'update_available=\"<span style='\''color:red'\''>GitHub'da bir ${app_name} güncellemesi mevcuttur.</span> Lütfen ${local_version} sürümünüzü sürüme güncelleyin\"'"
txtAlertOnlyAdmin="'txtAlertOnlyAdmin=\"Erişime yalnızca administrators grubu üyeleri için izin verilir\"'"
txtLanguageSource="'txtLanguageSource=\"Bu sayfanın dili web tarayıcınızın bölgesel ayarlarına göre seçilmiştir.\"'"
preinstDsmVersError="'preinstDsmVersError=\"Bu paket sürümü yalnızca DSM ${osMin} ve üzeri sürümlerde kullanılabilir! DSM sürümünüzde daha önceki paket sürümleri mümkün olabilir, bkz: <a target='\''_blank'\'' rel='\''noopener noreferrer'\'' href='\''https://github.com/reidemei/synology-autorun#install'\''>https://github.com/reidemei/synology-autorun#install</a>\""

