#!/bin/bash
# This file was generated via DeepL machine translation from en
# Filename: <lng>/lang.txt - coded in utf-8
# Language variables for cgi pages in the user language
# --------------------------------------------------------------
displaynameINFO="Autorun"
descriptionINFO="Spustí skript pro externí disk (USB / eSATA) po jeho připojení k diskové stanici."
LoginRequired="Vyžaduje se přihlášení"
PleaseLogin="Před použitím této webové stránky se nejprve přihlaste jako správce."
settingsTitle="Aktuální nastavení $app_name:"
logTitleExec="Protokol akcí (připojení zařízení, spuštění skriptu a vysunutí zařízení)"
logTitleDetail="Protokol ladění činností. Skutečná úroveň protokolu je '$LOGLEVEL'."
settingFingerprint="Skript spuštěný s přístupem roota představuje bezpečnostní riziko, zejména pokud je nakonfigurován s umístěním na externím úložišti. Spuštění lze omezit na skripty, které odpovídají dříve zaregistrovanému kontrolnímu součtu SHA256.<br>0: Bez omezení. Dříve registrované kontrolní součty jsou zachovány.<br>1: Pokud existují dříve registrované kontrolní součty, jsou odstraněny. Jako povolený kontrolní součet je zaregistrován 1. skript s jeho kontrolním součtem.<br>2: Všechny skripty jsou povoleny a jsou zaregistrovány jejich kontrolní součty, pokud již nebyly zaregistrovány dříve.<br>3: Jsou povoleny pouze skripty s dříve zaregistrovanými kontrolními součty."
settingSecurityWarning="<span style=\"color:red\"><b>Upozornění:</b></span> Kombinace varianty skriptu a) (skript na externím zařízení USB/eSATA) s nastavením otisku prstu 0 nebo 2 může představovat kritické bezpečnostní riziko: Skripty s libovolným obsahem na externím úložném zařízení se po připojení spustí a mají přístup ke všemu! Zapojení může stačit ke zničení nebo odcizení dat na zařízení Synology NAS!"
settingScript="Varianta a: Skript je umístěn v kořenovém adresáři externího paměťového zařízení a je nastaven jako spustitelný pro uživatele \"root\". Zadán je čistý název skriptu bez cesty a lomítka.<br>Varianta b: Skript je zadán s plnou cestou a je umístěn na NAS.<br> Jako první parametr (\$1) získá přípojný bod zařízení (např. /volumeUSB1/usbshare/) a jako druhý (\$2) oddíl zařízení (např. usb1p1). Musí být spustitelný pro 'root'. V DSM 7 se pro 'root' používá shell 'ash'. Ale /bin/ash může být odkazem na 'bash' (alespoň na DS220 ). Skript je spuštěn s prázdným prostředím! Není tedy nastaveno žádné prostředí PATH. Musíte použít pro každý příkaz úplnou cestu (např. /bin/echo \"...\", /bin/printf ...). Váš skript se může zastavit s kódem ukončení 2, pokud příkaz nebyl nalezen kvůli chybějící cestě. V prvních řádcích vašeho skriptu můžete použít příkaz 'unset PATH', abyste měli v ladicích bězích skriptu stejné podmínky. Nebo na začátek skriptu přidáte řádek jako 'PATH=/sbin:/bin:/usr/sbin:/usr/bin:/usr/syno/sbin:/usr/syno/bin:/usr/local/sbin:/usr/local/bin'."
settingScriptAfter="Pokud skript skončí s některým z definovaných kódů ukončení, autorun vysune toto úložné zařízení a poté zavolá tento druhý skript. To je nepovinné. Typické použití je vypnutí pevného disku s externím napájením pomocí inteligentního napájecího adaptéru."
settingTries="Doba (v sekundách), jak dlouho má autorun hledat připojenou jednotku. Tuto hodnotu zvyšte, pokud se objeví chyba \"nelze najít přípojný bod\"."
settingWait="Před spuštěním skriptu je detekována dodatečná čekací doba (v sekundách) po připojení. V některých případech je pro správný přístup k jednotce nutná několikasekundová prodleva."
settingBeep="Pokud je nastavena hodnota true, ozve se při nalezení skriptu krátké pípnutí. A trojnásobné dlouhé pípnutí v případě chyby."
settingLedStatus="Stavová LED dioda může být použita k zobrazení stavu skriptu.<br>0: Stavová LED dioda se v tomto balíčku nepoužívá.<br>1: 1: Zelená za běhu, zelené blikání při vysunutí, vypnutá, pokud skončila s 0 nebo jedním z kódů definovaných pro vysunutí, oranžové blikání při jiných výsledcích nebo neúspěšném vysunutí<br/>2: Zelené blikání při běhu skriptu nebo vysunutí, zelené, pokud skončila s 0 nebo jedním z kódů definovaných pro vysunutí, oranžové blikání při jiných výsledcích nebo neúspěšném vysunutí<br/>3: Zelená za běhu skriptu a při vysunutí, vypnutá, pokud skončila, oranžové blikání při neúspěšném vysunutí."
settingLedCopy="Stavová LED dioda může být také použita k zobrazení stavu skriptu.<br>0: Kopírovací LED dioda se v tomto balíčku nepoužívá.<br>1: Svítí za chodu nebo při vysunutí, poté zhasne<br/>2: Bliká za chodu nebo při vysunutí, poté zhasne<br/>3: Svítí za chodu nebo při vysunutí, poté zhasne (0 nebo jeden z kódů s vysunutím) nebo bliká (ostatní kódy)<br/>4: Bliká při běhu nebo vysunutí, poté OFF nebo bliká (jiné kódy nebo vysunutí selhalo)<br/>5: Bliká při běhu nebo vysunutí, poté OFF (0 nebo jeden z kódů s vysunutím) nebo ON (jiné kódy nebo vysunutí selhalo)."
settingNoDsmMessageReturnCodes="Obvykle se po dokončení skriptu vygeneruje zpráva na ploše DSM. Zpráva obsahuje návratový kód skriptu a zbývající volné místo na úložném zařízení. Pokud váš skript skončí s jedním ze zde uvedených kódů, pak se žádná taková zpráva negeneruje. Přesto je vygenerován záznam v souboru protokolu balíčku."
settingEjectTimeout="Pokud v případě výstupního kódu nakonfigurovaného pro vysunutí zařízení nelze externí jednotku vysunout (protože je obsazená), je zde uveden časový limit v sekundách před ukončením pokusů o vysunutí s chybou."
settingLogMaxLines="Aby se předešlo tomu, že soubory protokolu zaberou příliš mnoho místa, je starší polovina souborů smazána, pokud počet řádků dosáhne daného počtu."
settingLogVerbose="Pro zápis zpráv do souboru protokolu ladění je k dispozici několik úrovní podrobnosti: 1 ... 8. Čím vyšší hodnota, tím více podrobností."
settingNotifyUsers="Balíček generuje oznámení na ploše, která se zobrazují konfigurovatelnému uživateli nebo skupině uživatelů. Jméno začínající na '@' je jméno skupiny, takže se zobrazuje všem jejím členům.<br>Nápověda:<br> Administrátoři jsou také členy skupiny <code>@users</code>.<br>Příkazem <code>/usr/syno/bin/synodsmnotify -c \\"SYNO.SDS._ThirdParty.App.autorun\\" \\"@users\\". \\"autorun:app1:title02\\" \\"autorun:app1:msg0\\" \\"\<Váš text zprávy\>\\"</code> můžete generovat další zprávy ze svých skriptů."
settingHeadlineFingerprints="Aktuálně registrované kontrolní součty SHA256 (otisky prstů) souborů skriptů:"
settingCapture="Výstup na stdout vašeho skriptu (nebo skriptů) může být vložen do protokolu Autorun:<br>0: Výstup není zachycen.<br>1: Výstup je vložen do hlavního protokolu akce Autorun.<br>2: Výstup je vložen do protokolu ladění."
settingsEjectReturnCodes="Váš skript může skončit s návratovým kódem 0 ... 255. Můžete zadat některé návratové kódy nebo rozsahy návratových kódů, pro které bude externí paměťové zařízení po dokončení skriptu vysunuto."
settingFailureCodes="Seznam kódů ukončení skriptu, které jsou považovány za selhání a případně signalizovány LED diodami nebo zvukovým signálem."
settingCGIDEBUG="&lt;empty&gt;: <br>zaškrtnuto: Spuštění souborů index.cgi a settings.cgi negeneruje záznamy v logu ladění: Provedení index.cgi a settings.cgi generuje záznamy ladicího protokolu. To může být matoucí při ladění jiných problémů."
runInstallationAgain="Instalaci můžete spustit znovu, abyste změnili nastavení nebo odstranili kontrolní součty!"
ledCtrlHint="Pokud je indikace LED stále chybná, můžete ji zde resetovat:"
btnLedOff="OFF"
btnLedOn="NA"
btnStatusLedGreen="Zelená"
labelStatusLed="Stavová LED dioda"
labelCopyLed="Kopírování LED"
btnLedFlash="blikající"
btnLedGreenFlash="Zelené blikání"
btnLedOrangeFlash="Oranžové blikání"
btnLedOrange="oranžová"
btnDelLog="Smazání tohoto souboru protokolu"
btnRefresh="Obnovit stránku"
btnShowDetailLog="Zobrazit podrobný soubor protokolu ladění"
btnShowSimpleLog="Zobrazit soubor protokolu akce"
hrefLog="Záznam o akcích"
btnShowLicence="Licence"
btnShowSettings="Zobrazit nastavení"
btnDownload="Stáhnout ..."
execLogNA="Soubor protokolu nebyl nalezen nebo je prázdný. Došlo od spuštění k nějakým událostem, které se mají zaznamenat?"
HASH_DELETION="<b>Předchozí registrované hashe jsou nyní všechny smazány.</b>"
copyPrivilege="<strong>Důležité:</strong> Vzhledem k tomu, že balíčky třetích stran jsou v systému DSM 7.x společností Synology omezeny, je k dokončení instalace a spuštění balíčku nutný další krok:<br>Je třeba provést následující příkaz: <input type='text' size='80' value='sudo cp /var/packages/\$SYNOPKG_PKGNAME/conf/privilege.root /var/packages/\$SYNOPKG_PKGNAME/conf/privilege'> <strong>Příkaz 1:</strong><br>Otevřete příkazový shell SSH k NAS (jako uživatel admin) a proveďte výše uvedený příkaz. Poté pokračujte a <strong>spusťte</strong> balíček.<br><strong>Možnost 2:</strong><br>Nápověda: Pokud jste to již provedli dříve, můžete přejít ke kroku 2.2.<br>2.1: Přejděte nyní v ovládacím panelu do \"Plánovače úloh\" a vytvořte naplánovanou úlohu s uživatelsky definovaným skriptem. Na kartě obecné nastavte užitečný název a jako uživatele vyberte \"root\". Jako 'Plán' můžete vybrat datum v minulosti a 'Neopakovat'. V 'Nastavení úlohy' zkopírujte a vložte výše uvedený příkaz jako 'Uživatelsky definovaný skript'. Dokončete toto nastavení úlohy a potvrďte upozornění.<br>2.2: Vyberte vygenerovanou úlohu a <strong>spusťte ji</strong>.<br>2.3: Zavřete Ovládací panely a také tento dialog zde. Přejděte v Centru balíčků do sekce \"Nainstalované balíčky\", vyberte balíček Autorun a <strong>spusťte jej</strong>!"
scriptNA="Chyba: Skript '$f' nebyl nalezen!"
scriptNAcase="Podezřelé: Nalezen soubor s různými velkými/malými písmeny!"
setupCorrection="Je možné, že budete muset instalaci spustit znovu, abyste nastavení opravili!"
scriptNexec="Chyba: Skript '$f' není spustitelný!"
wrongLineBreakWin="Chyba: Skript '$f', který by měl být proveden, používá nesprávný zlom řádku CR/LF (Windows). Použijte prosím siutabilní editor (Linux oder Windows Notepad  , PSPad, ...) a změňte jej na LF (UNIX)!"
wrongCodePage="Chyba: Skript '$f', který by měl být proveden, používá nesprávné kódování (Windows ISO-8859). Použijte siutable Editor (Linux oder Windows Notepad  , PSPad, ...) pro změnu na UTF-8!"
wrongLineBreakMac="Chyba: Skript '$f', který by měl být proveden, používá špatné zalomení řádku CR (MAC). Použijte prosím siutable editor a změňte jej na LF (UNIX)!"
notifyUserError="Uživatelský účet '$notyfyUsers' pro zprávy z plochy neexistuje! Proto je chybný záznam nahrazen skupinou '@users'. Spusťte instalaci znovu a zadejte jinou hodnotu!"
notifyGroupError="Uživatelská skupina '$notyfyUsers' pro zprávy z plochy neexistuje! Proto je chybná položka nahrazena položkou '@users'. Spusťte instalaci znovu a zadejte jinou hodnotu!"
update_available="<span style='color:red'>Na GitHubu je k dispozici aktualizace ${název_aplikace}.</span> Aktualizujte prosím svou verzi ${lokální_verze} na verzi"
txtAlertOnlyAdmin="Přístup je povolen pouze členům skupiny administrátorů."
txtLanguageSource="Jazyk této stránky byl zvolen podle regionálního nastavení webového prohlížeče."
preinstDsmVersError="Tuto verzi balíčku lze použít pouze v DSM ${osMin} a vyšší! Ve vaší verzi DSM mohou být možné i starší verze balíčku, viz <a target='_blank' rel='noopener noreferrer' href='https://github.com/reidemei/synology-autorun#install'>https://github.com/reidemei/synology-autorun#install</a>."
details="Podrobnosti na"
notAccepted="Licence ještě není přijata!"
