#!/bin/bash
# This file was generated via DeepL machine translation from en
# Filename: <lng>/lang.txt - coded in utf-8
# Language variables for cgi pages in the user language
# --------------------------------------------------------------
displaynameINFO="Autorun"
descriptionINFO="Executa um script em/para um drive externo (USB / eSATA) após ser conectado à Estação de Disco."
LoginRequired="Login Necessário"
PleaseLogin="Faça o login como administrador primeiro, antes de usar esta página web"
settingsTitle="Configurações reais de $app_name:"
logTitleExec="Registro de ações (conexão de dispositivos, execução de scripts e ejeção de dispositivos)"
logTitleDetail="Registro de depuração das atividades. O nível real de log é '$LOGLEVEL'."
settingFingerprint="O script executado com acesso root é um risco de segurança, especialmente se for configurado com localização no armazenamento externo. A execução pode ser restrita a scripts que correspondam ao checksum SHA256 previamente registrado.<br>0: Sem restrições. Os checksums previamente registrados são preservados.<br>1: Se houver checksums previamente registrados, eles são excluídos. O primeiro script com seu checksum é registrado como checksum permitido.<br>2: Todos os scripts são permitidos e há checksums registrados, se não já registrados antes.<br>3: Somente scripts com checksums previamente registrados são permitidos."
settingSecurityWarning="<span style=\"color:red\"><b>Attention:</b></span> Combinando a variante de script a) (script no dispositivo externo USB/eSATA) com a configuração de impressão digital 0 ou 2 pode ser um risco crítico de segurança: Scripts com conteúdo arbitrário no dispositivo de armazenamento externo são executados quando conectados e têm acesso a tudo! Conectá-lo pode ser suficiente para destruir ou roubar os dados em seu NAS Synology!"
settingScript="Variante a: O script está localizado no diretório raiz do dispositivo de armazenamento externo e definido como executável para o usuário 'raiz'. Dado é o nome puro do script sem nenhum caminho ou barra oblíqua.<br>Variante b: O script é dado com seu caminho completo e está localizado no NAS.<br> Obtém o ponto de montagem do dispositivo (por exemplo /volumeUSB1/usbshare/) como o primeiro parâmetro (\$1) e a partição do dispositivo (por exemplo usb1p1) como o segundo (\$2). Ele precisa ser executável para 'root'. Para 'root' está no DSM 7 o shell 'ash' utilizado. Mas o /bin/ash pode ser um link para 'bash' (pelo menos em um DS220 ). O script começou com um ambiente vazio! Portanto, nenhum PATH está definido. Você tem que usar para cada comando o caminho completo (por exemplo, /bin/echo \"...\", /bin/printf ...). Seu script pode parar com o código de saída 2 se um comando não for encontrado devido a um caminho em falta. Nas primeiras linhas de seu script, você pode usar um 'PATH não definido' para ter na execução de depuração do script as mesmas condições. Ou você adiciona uma linha como 'PATH=/sbin:/bin:/usr/sbin:/usr/bin:/usr/syno/sbin:/usr/syno/bin:/usr/local/sbin:/usr/local/bin' ao início de seu script."
settingScriptAfter="Se o script sair com alguns códigos de saída definidos, então a autorun ejetará aquele dispositivo de armazenamento e depois chamará este segundo script. Isto é opcional. O uso típico é para desligar um HDD com alimentação externa através de um adaptador de energia inteligente."
settingTries="O tempo (em segundos) durante o qual a auto-execução deve procurar por um acionamento montado. Aumente este valor quando você obtiver o erro \"incapaz de encontrar o ponto de montagem\"."
settingWait="Um tempo de espera adicional (em segundos) após a montagem é detectado antes de iniciar o roteiro. Em alguns casos, é necessário um atraso de alguns segundos para um acesso adequado ao drive."
settingBeep="Se definido como \"verdadeiro\", há um breve sinal sonoro quando um roteiro é encontrado. E um bip longo triplo no caso de um erro."
settingLedStatus="O LED de status pode ser usado para mostrar o status do script.<br>0: O LED de status não é usado por este pacote.<br>1: 1: Verde durante a execução, verde piscando durante a ejeção, OFF se terminado com 0 ou um dos códigos definidos para ejeção, laranja piscando para outros resultados ou falha na ejeção<br/>2: Verde piscando durante a execução ou ejeção do script, verde se terminado com 0 ou um dos códigos definidos para ejeção, laranja piscando para outros resultados ou falha na ejeção<br/>3: Verde durante a execução do script e durante a ejeção, OFF quando terminado, laranja piscando se falha na ejeção."
settingLedCopy="O LED de status também pode ser usado para mostrar o status do roteiro.<br>0: O LED de cópia não é usado por este pacote.<br>1: LIGADO durante a execução ou ejeção, DESLIGADO depois <br/>2: Intermitente durante a execução ou ejeção, DESLIGADO depois <br/>3: LIGADO durante a execução ou ejeção, depois DESLIGADO (0 ou um dos códigos com ejeção) ou intermitente (outros códigos)<br/>4: Intermitente durante a corrida ou ejeção, depois OFF ou intermitente (outros códigos ou falha de ejeção)<br/>5: Intermitente durante a corrida ou ejeção, depois OFF (0 ou um dos códigos com ejeção) ou ON (outros códigos ou falha de ejeção)<br/>5: Intermitente durante a corrida ou ejeção, depois OFF (0 ou um dos códigos com ejeção) ou ON (outros códigos ou falha de ejeção)"
settingNoDsmMessageReturnCodes="Normalmente há uma mensagem de área de trabalho DSM gerada após o término de seu script. A mensagem contém o código de retorno de seu script e o espaço livre restante no dispositivo de armazenamento. Se seu script sair com um dos códigos dados aqui, então não será gerada tal mensagem. Uma entrada no arquivo de log do pacote ainda é gerada."
settingEjectTimeout="Se no caso de um código de saída configurado para a ejeção do dispositivo, o drive externo não pode ser ejetado (por estar ocupado), isto dá o tempo limite em segundos antes de terminar as tentativas de ejeção com erro."
settingLogMaxLines="Para evitar que muito espaço seja ocupado pelos arquivos de registro, a metade mais velha dos arquivos é apagada se a contagem de linhas tiver alcançado o número dado."
settingLogVerbose="Vários níveis de detalhe estão disponíveis para escrever mensagens para o arquivo de registro de depuração: 1 ... 8. Quanto mais alto o valor, mais detalhes."
settingNotifyUsers="O pacote gera notificações no desktop, que são mostradas a um usuário ou grupo de usuários configurável. Um nome começando com '@' é um nome de grupo, de modo que é mostrado a todos esses membros.<br>Dicas:<br>Os administradores também são membros do grupo <código>@usuários</código>.<br>Com o comando <código>/usr/syno/bin/synodsmnotify -c \"SYNO.SDS._ThirdParty.App.autorun\" \"@users\" \"autorun:app1:title02\" \"autorun:app1:msg0\" \Seu texto de mensagem."
settingHeadlineFingerprints="Atualmente SHA256 checksums (impressões digitais) registrados de arquivos de script:"
settingCapture="A saída para stdout de seu script (ou scripts) pode ser inserida no log do Autorun:<br>0: A saída não é capturada.<br>1: A saída é inserida no log de ação principal do Autorun.<br>2: A saída é inserida no log de debug."
settingsEjectReturnCodes="Seu script pode sair com um código de retorno 0 ... 255. Você pode especificar alguns códigos de retorno ou intervalos de códigos de retorno para os quais o dispositivo de armazenamento externo é ejetado após o término de seu script."
settingFailureCodes="Lista de códigos de saída do roteiro, que são considerados como uma falha e possivelmente sinalizados pelos LEDs ou pelo beeper."
settingCGIDEBUG="&lt;vazio&gt;: A execução de index.cgi e settings.cgi não gera entradas de registro de depuração.<br>checked: A execução de index.cgi e settings.cgi gera entradas de registro de depuração. Isto pode ser confuso durante a depuração de outras questões."
runInstallationAgain="Você pode executar a instalação novamente para alterar as configurações ou para excluir os checksums!"
ledCtrlHint="Se os LEDs ainda indicarem um erro, você pode redefini-lo aqui:"
btnLedOff="OFF"
btnLedOn="ON"
btnStatusLedGreen="Verde"
labelStatusLed="LED de status"
labelCopyLed="Copiar LED"
btnLedFlash="piscando"
btnLedGreenFlash="Cintilação verde"
btnLedOrangeFlash="Laranja piscando"
btnLedOrange="laranja"
btnDelLog="Apagar este arquivo de log"
btnRefresh="Página de Atualização"
btnShowDetailLog="Mostrar arquivo detalhado de registro de depuração"
btnShowSimpleLog="Mostrar arquivo de log de ação"
hrefLog="Log de ações"
btnShowLicence="Licença"
btnShowSettings="Mostrar configurações"
btnDownload="Baixar ..."
execLogNA="Arquivo de log não encontrado ou vazio. Houve algum evento a ser registrado desde o lançamento?"
HASH_DELETION="<b> hashes registrados anteriormente são todos apagados agora.</b>"
copyPrivilege="<forte>Importante:</strong> Como os pacotes de terceiros são restritos pela Synology no DSM 7.x, um passo adicional é necessário para finalizar a instalação e poder executar o pacote:<br>É preciso executar o seguinte comando: <input type='text' size='80' value='sudo cp /var/packages/\$SYNOPKG_PKGNAME/conf/privilege.root /var/packages/\$SYNOPKG_PKGNAME/conf/privilege'> <strong>Posibillity 1:</strong>>br>Abra uma shell de comando SSH ao seu NAS (como usuário administrador) e execute o comando acima. Depois disso, continue e <forte>Executar>forte> o pacote.<br>forte>Possibilidade 2:</strong>>br>Possibilidade 2:</strong>>br>Dica: Se você já fez isso antes, você pode pular para o passo 2.2.<br>2.1: Vá agora no painel de controle para o 'Agendador de Tarefas' e crie uma tarefa agendada com um script definido pelo usuário. Na aba geral defina um nome útil e selecione 'root' como o usuário. Como 'Programar' você pode selecionar uma data no passado e a opção 'Não repetir'. Em 'Configurações de tarefas', copie e cole o comando acima como 'Script definido pelo usuário'. Termine essa configuração de tarefa e confirme o aviso.<br>2.2: Selecione a tarefa gerada e <forte>correr</strong> it.<br>2.3: Feche o Painel de Controle e também este diálogo aqui. Vá no Centro de Pacotes para 'Pacotes instalados', selecione o pacote Autorun e <strong>Run</strong> it.<br>strong> it.<b>2.2: Selecione a tarefa gerada e"
scriptNA="Erro: O Skript '$f' não pôde ser encontrado!"
scriptNAcase="Suspeito: Arquivo com diferentes caixas superior/inferior encontradas!"
setupCorrection="Possivelmente você precisará executar a instalação novamente para corrigir a configuração!"
scriptNexec="Erro: O Skript '$f' não é executável!"
wrongLineBreakWin="Erro: O Skript '$f', que deve ser executado, usa a quebra de linha errada CR/LF (Windows). Por favor, use um Editor siutable (Linux ou Windows Notepad  , PSPad, ...) para mudá-lo para LF (UNIX)!"
wrongCodePage="Erro: O Skript '$f', que deve ser executado, utiliza a codificação errada (Windows ISO-8859). Por favor, use um editor siutable (Linux ou Windows Notepad  , PSPad, ...) para mudá-lo para UTF-8!"
wrongLineBreakMac="Erro: O Skript '$f', que deve ser executado, usa a quebra de linha errada CR (MAC). Por favor, use um Editor siutable para mudá-lo para LF (UNIX)!"
notifyUserError="A conta de usuário '$notyfyUsers' para mensagens desktop não existe! Portanto, a entrada errada foi substituída pelo grupo '@usuários'. Execute a instalação novamente para inserir outro valor!"
notifyGroupError="O grupo de usuários '$notyfyUsers' para mensagens desktop não existe! Portanto, a entrada errada foi substituída por '@usuários'. Execute a instalação novamente para inserir outro valor!"
update_available="<span style='color:red'>A atualização ${app_name} está disponível no GitHub.</span> Por favor atualize sua versão ${local_version} para a versão"
txtAlertOnlyAdmin="O acesso é permitido somente para membros do grupo de administradores"
txtLanguageSource="O idioma desta página foi selecionado de acordo com as configurações regionais de seu navegador da Web."
preinstDsmVersError="Esta versão do pacote só pode ser usada em DSM ${osMin} e acima! Versões anteriores do pacote podem ser possíveis em sua versão DSM, veja <a target='_blank' rel='noopener noreferrer' href='https://github.com/reidemei/synology-autorun#install'>https://github.com/reidemei/synology-autorun#install</a>"
details="Detalhes"
notAccepted="A licença ainda não é aceita!"
