#!/bin/bash
# This file was generated via DeepL machine translation from en
# Filename: <lng>/lang.txt - coded in utf-8
# Language variables for cgi pages in the user language
# --------------------------------------------------------------
displaynameINFO="Autorun"
descriptionINFO="Esegue uno script sull'unità esterna (USB / eSATA) quando è collegata alla stazione disco."
LoginRequired="Accesso richiesto"
PleaseLogin="Prima di utilizzare questa pagina web, effettuare il login come amministratore."
settingsTitle="Impostazioni effettive di $nome_app:"
logTitleExec="Registro delle azioni (aggancio del dispositivo, esecuzione di script ed espulsione del dispositivo)"
logTitleDetail="Registro di debug delle attività. Il livello di log effettivo è '$LOGLEVEL'."
settingFingerprint="Gli script eseguiti con accesso root rappresentano un rischio per la sicurezza, soprattutto se sono configurati con una posizione sulla memoria esterna. L'esecuzione può essere limitata agli script che corrispondono alla somma di controllo SHA256 precedentemente registrata.<br>0: Nessuna restrizione. Le checksum precedentemente registrate vengono conservate.<br>1: Se esistono checksum precedentemente registrate, vengono eliminate. Il primo script con la sua somma di controllo viene registrato come somma di controllo consentita.<br>2: Tutti gli script sono consentiti e le loro somme di controllo vengono registrate, se non già registrate in precedenza.<br>3: Sono consentiti solo gli script con somme di controllo registrate in precedenza."
settingSecurityWarning="<span style=\"color:red\"><b>Attenzione:</b></span> La combinazione della variante di script a) (script su dispositivo esterno USB/eSATA) con l'impostazione dell'impronta digitale 0 o 2 può rappresentare un rischio critico per la sicurezza: Gli script con contenuto arbitrario sul dispositivo di archiviazione esterno vengono eseguiti quando è collegato e hanno accesso a tutto! Collegarlo può essere sufficiente per distruggere o rubare i dati sul NAS Synology!"
settingScript="Variante a: Lo script si trova nella directory principale del dispositivo di archiviazione esterno ed è impostato come eseguibile per l'utente 'root'. Viene fornito il nome puro dello script senza alcun percorso o barra.<br>Variante b: Lo script viene fornito con il suo percorso completo e si trova sul NAS.<br>Ottiene il punto di montaggio del dispositivo (ad esempio, /volumeUSB1/usbshare/) come primo parametro (\$1) e la partizione del dispositivo (ad esempio, usb1p1) come secondo (\$2). Deve essere eseguibile per 'root'. Per 'root' in DSM 7 si usa la shell 'ash'. Ma /bin/ash può essere un collegamento a 'bash' (almeno su DS220 ). Lo script viene avviato con un ambiente vuoto! Quindi non viene impostato alcun PATH. È necessario utilizzare per ogni comando il percorso completo (ad esempio, /bin/echo \"...\", /bin/printf ...). Lo script potrebbe interrompersi con il codice di uscita 2 se un comando non viene trovato a causa di un percorso mancante. Nelle prime righe dello script, si può usare un 'unset PATH' per avere nelle esecuzioni di debug dello script le stesse condizioni. Oppure aggiungete una riga come 'PATH=/sbin:/bin:/usr/sbin:/usr/bin:/usr/syno/sbin:/usr/syno/bin:/usr/local/sbin:/usr/local/bin' all'inizio del vostro script."
settingScriptAfter="Se lo script esce con il codice di uscita 100, autorun espellerà il dispositivo di memorizzazione e successivamente chiamerà questo secondo script. Questo è facoltativo. L'uso tipico è quello di spegnere un'unità disco con alimentazione esterna tramite un adattatore di alimentazione intelligente."
settingTries="Il tempo (in secondi) per cui autorun deve cercare un'unità montata. Aumentare questo valore quando si verifica l'errore \"unable to find mount point\"."
settingWait="Prima di avviare lo script, viene rilevato un tempo di attesa aggiuntivo (in secondi) dopo il montaggio. In alcuni casi è necessario un ritardo di alcuni secondi per accedere correttamente all'unità."
settingBeep="Se impostato su 'true', viene emesso un breve segnale acustico quando viene trovato uno script. E un triplice segnale acustico lungo in caso di errore."
settingLedStatus="Il LED di stato può essere utilizzato per mostrare lo stato dello script.<br>0: Il LED di stato è utilizzato da questo pacchetto.<br>1: 1: Verde durante l'esecuzione, verde lampeggiante durante l'espulsione, spento se terminato con 0 o 100, arancione lampeggiante per altri risultati o espulsione fallita<br/>2: Verde lampeggiante durante l'esecuzione dello script o l'espulsione, verde se terminato con 0 o 100, arancione lampeggiante per altri risultati o espulsione fallita<br/>3: Verde durante l'esecuzione dello script e durante l'espulsione, spento quando terminato, arancione lampeggiante se espulsione fallita."
settingLedCopy="Il LED di stato può essere utilizzato anche per mostrare lo stato dello script.<br>0: Il LED di copia è utilizzato da questo pacchetto.<br>1: Acceso durante l'esecuzione o l'espulsione, successivamente spento<br/>2: Lampeggiante durante l'esecuzione o l'espulsione, successivamente spento<br/>3: Acceso durante l'esecuzione o l'espulsione, successivamente spento (0/100) o lampeggiante (altri codici)<br/>4: Lampeggiante durante l'esecuzione o l'espulsione, successivamente spento o lampeggiante (altri codici o espulsione fallita)<br/>5: Lampeggiante durante l'esecuzione o l'espulsione, successivamente spento (0/100) o acceso (altri codici o espulsione fallita)"
settingNoDsmMessageReturnCodes="Normalmente, al termine dello script viene generato un messaggio sul desktop del DSM. Il messaggio contiene il codice di ritorno dello script e lo spazio libero rimanente sul dispositivo di memorizzazione. Se lo script esce con uno dei codici indicati qui, non viene generato alcun messaggio. Viene comunque generata una voce nel file di log del pacchetto."
ledResetHint="A seconda delle impostazioni dei LED, i LED del dispositivo possono indicare una condizione di errore al termine dello script. Con il comando <span style=\"font-family:'Courier New'\" translate='no'>echo 8 4 B> /dev/ttyS1</span>, eseguito come '<span translate='no'>root</span>', è possibile ripristinare lo stato normale. È possibile creare un'attività pianificata nel pannello di controllo per uno script personalizzato per l'utente <span translate='no'>root</span> con il comando di esecuzione <span style=\"font-family:'Courier New'\" translate='no'>echo 8 4 B> /dev/ttyS1</span> (8: LED di stato verde, 4: LED di alimentazione acceso, B: LED di copia spento). Eseguire il comando se è necessario resettare i LED."
settingEjectTimeout="Se in caso di codice di uscita 100 l'unità esterna non può essere espulsa (perché è occupata), questo fornisce il timeout in secondi prima di terminare i tentativi di espulsione con un errore."
settingLogMaxLines="Per evitare che i file di log occupino troppo spazio, la metà più vecchia dei file viene cancellata se il conteggio delle righe raggiunge il numero indicato."
settingLogVerbose="Sono disponibili diversi livelli di dettaglio per la scrittura dei messaggi nel file di log di debug: 1 ... 8. Più alto è il valore, maggiore è il numero di dettagli."
settingNotifyUsers="Il pacchetto genera notifiche sul desktop, che vengono mostrate a un utente o a un gruppo di utenti configurabile. Un nome che inizia con '@' è un nome di gruppo."
settingHeadlineFingerprints="checksum SHA256 (impronte digitali) dei file di script attualmente registrati:"
runInstallationAgain="È possibile eseguire nuovamente l'installazione per modificare le impostazioni o cancellare le checksum!"
ledCtrlHint="Se l'indicazione dei LED è ancora un errore, è possibile ripristinarla qui:"
btnCopyLedOff="LED di copia spento"
btnStatusLedGreen="LED di stato verde"
btnStatusLedOff="LED di stato spento"
btnDelLog="Cancellare questo file di registro"
btnRefresh="Aggiorna la pagina"
btnShowDetailLog="Mostra un file di log di debug dettagliato"
btnShowSimpleLog="Mostra un registro semplice"
hrefLog="Registro delle azioni"
btnShowLicence="Licenza"
btnShowSettings="Mostra impostazioni"
btnDownload="Scaricare ..."
execLogNA="Il file di registro non è stato trovato o è vuoto. All'avvio di questo pacchetto era già collegato un dispositivo di archiviazione con un file di script nella cartella principale?"
HASH_DELETION="<b>I precedenti hashtag registrati sono stati cancellati."
copyPriviledge="È possibile eseguire il comando richiesto <input type='text' size='80' value='sudo cp /var/packages/$SYNOPKG_PKGNAME/conf/privilege.root /var/packages/$SYNOPKG_PKGNAME/conf/privilege'> tramite SSH (o un'attività pianificata)<strong>ora!</strong> Dopo aver dato l'\"OK\", è possibile avviare il pacchetto con \"Esegui\"."
scriptNA="Errore: Lo Skript '$f' non è stato trovato!"
scriptNAcase="Sospetto: trovato un file con maiuscole/minuscole diverse!"
setupCorrection="Forse è necessario eseguire nuovamente l'installazione per correggere l'impostazione!"
scriptNexec="Errore: Lo Skript '$f' non è eseguibile!"
wrongLineBreakWin="Errore: Lo Skript '$f', che dovrebbe essere eseguito, utilizza un'interruzione di riga errata CR/LF (Windows). Si prega di utilizzare un editor di tipo siutable (Linux o Windows Notepad  , PSPad, ...) per cambiarlo in LF (UNIX)!"
wrongCodePage="Errore: Lo Skript '$f', che dovrebbe essere eseguito, utilizza una codifica errata (Windows ISO-8859). Si prega di utilizzare un editor di siute (Linux o Windows Notepad  , PSPad, ...) per cambiarlo in UTF-8!"
wrongLineBreakMac="Errore: Lo Skript '$f', che dovrebbe essere eseguito, utilizza l'interruzione di riga errata CR (MAC). Si prega di utilizzare un editor siutable per cambiarlo in LF (UNIX)!"
notifyUserError="L'account utente '$notyfyUsers' per i messaggi sul desktop non esiste! Pertanto la voce errata è stata sostituita dal gruppo '@users'. Eseguire nuovamente l'installazione per inserire un altro valore!"
notifyGroupError="Il gruppo di utenti '$notyfyUsers' per i messaggi sul desktop non esiste! Pertanto la voce errata è stata sostituita da '@users'. Eseguire nuovamente l'installazione per inserire un altro valore!"
update_available="<span style='color:red'>Un aggiornamento di ${app_name} è disponibile su GitHub.</span> Aggiornare la versione ${local_version} alla versione"
txtAlertOnlyAdmin="L'accesso è consentito solo ai membri del gruppo amministratori."
txtLanguageSource="La lingua di questa pagina è stata selezionata in base alle impostazioni regionali del browser."
preinstDsmVersError="Questa versione del pacchetto può essere utilizzata solo in DSM ${osMin} e superiori! Versioni precedenti del pacchetto possono essere utilizzate con la propria versione di DSM, vedere <a target='_blank' rel='noopener noreferrer' href='https://github.com/reidemei/synology-autorun#install'>https://github.com/reidemei/synology-autorun#install</a>"

